More than the terrorist , its people like @SudheenKulkarni who are Blot on the society #ParisShooting #CharlieHebdo http t co 8eB7ewyi9W	non-rumor
Bibi s vulgarity Using Paris shooting to justify Israeli colonialism Haaretz http t co fsBO5fg2aI #CharlieHebdo http t co YnF3JT6Q5m	non-rumor
The car used by armed gunmen who stormed the Paris offices of satirical newspaper #CharlieHebdo Photo D Faget #AFP http t co ZBkDglcBcE	non-rumor
Out of all the cartoons we 've seen , I think this is the most poignant , the most beautiful #JeSuisCharlie http t co Wk8M7EV3Eb	non-rumor
VIDEO Seconds after shooting Nathan Cirillo , #OttawaShooting suspect gets into car http t co tbPrMJhNu0	rumor
Look at the best of Charlie Hebdo 's covers right here http t co 7SHjMeJ0iD http t co H3nWH6q0Cy	non-rumor
Why I am Charlie Parisians share emotional messages with CNN http t co YtQdjs8HQ1 #JeSuisCharlie https t co 3SGWCHVGg0	non-rumor
JUST IN Two brothers responsible for Charlie Hebdo massacre have been killed in Dammartin standoff , according to multiple reports	non-rumor
The flag in the window of the Lindt cafe in Martin Place is not an Islamic State flag An explanation http t co PD570btTiZ #SydneySiege	rumor
2 new victims en route to Ottawa hospital 1 shot , both non life threatening , hospital says @MICHAELCTV , @CBCNews https t co wCqPcyqMxK	rumor
BREAKING French police convoy , helicopters rush to scene of operation to detain #CharlieHebdo shooting suspects , AP says	rumor
Hostage situation ongoing in Sydney business district LIVE http t co j1ljDbazOw UPDATES http t co PD7pVfU9pQ http t co KHoDrDWaeV	rumor
Hollywood on #CharlieHebdo shooting Free speech must be defended http t co J69G56xm3S http t co bIQizPgmWn	non-rumor
Hello fellow white people Lets try to show as much outrage for #Ferguson as we did for Facebook messenger 	non-rumor
 @NBCNews I demand that you retract the lie that #Ferguson people were shouting Kill the police Reporters at scene have refuted that 	rumor
RT @SoerenJuhl I dedicate this illustration to my French brothers and sisters of cartoons #CharlieHebdo #JeSuisCharlie http t co Z8xllO 	non-rumor
Worth remembering Jens Stoltenberg 's words after Ut ya Our response is more democracy , more openness and more humanity #CharlieHebdo	non-rumor
All European flags fly at half mast today to pay tribute to the victims of the terrorist attack in Paris http t co S98A1Y5B7p	non-rumor
Two female hostages have run out of #SydneySiege 5 in total have escaped http t co isvMtY4oUQ http t co Xv2gJ1Q3zZ	rumor
The Prophet was insulted amp hit by stones , till his body was covered in blood Yet he forgave them , and prayed for them #CharlieHebdo	non-rumor
Report #Ferguson police beat up wrong suspect then charged him for getting blood on uniforms in 2009 http t co zmzd813Jzb	rumor
French officials confirm i d of #Germanwings copilot as being Andreas Lubitz Thought to be 28 y o Pictured here http t co bEKvhEACa1	rumor
Response to horrific #CharlieHebdo murders should be to protect civil liberties not limit them Not an excuse for more mass surveillance 	non-rumor
You 'd think it would 've been more newsworthy when Missouri got rid of due process and made shoplifting a capital crime #Ferguson #MikeBrown	rumor
GUNFIRE AND EXPLOSIONS CONTINUE AS POLICE STORM CAFE IN SYDNEY 	rumor
Why terrorists ca n't kill Charlie Hebdo s ideas http t co dHvxbOyF7g	non-rumor
What we do and do n't know about the aftermath of the Charlie Hebdo shooting http t co r7Zo8PQyCM http t co mu7n5BzGhR	non-rumor
#4U9525 From FL380 to FL110 in 8 min \? That 's average rate of descent 3375 fpm ! Than levelled off at FL068 \? What the hell was going on there \? 	rumor
BREAKING Hostages taken in central #Sydney caf , jihadist flag held against window http t co 7hJUmKz1eY http t co TeK7ZjFHm6	rumor
Shaheen Hashmat Islam is defined by its followers Moderate Muslims must act http t co wsiT3JzSBd \( Pic K PETERS \) http t co 4tWvhMEYce	non-rumor
There is no death penalty in France Good that those terrorist killers are killed #CharlieHebdo	non-rumor
#CharlieHebdo Paris media attack kills 4 cartoonists including chief editor #AFP http t co Zc8KZ0wNwR	rumor
#Ferguson cops beat innocent man then charged him for bleeding on them http t co u1ot9Eh5Cq via @MichaelDalynyc http t co AGJW2Pid1r	rumor
Proud ! When Youth of France stand up amp say #JesuisCharlie in HighSchool #Lyc eColomb #HauteSaone @MathildeGrillot http t co yQKViuS31Z	non-rumor
A million copies of Charlie Hebdo will be published Wednesday to show stupidity will not win http t co nwdVxrc5f9 http t co JXCOKGeTJC	non-rumor
So basically #Ferguson PD hijacked what was supposed to be a press conference about Darren Wilson to call Michael Brown a criminal #NMOS14	rumor
I 've redone the #CharlieHebdo comic I ca n't stop thinking about what happened http t co acx7vmr98c	non-rumor
NO , Michael Zehaf Bibeau was NOT wearing a GamerGate t shirt during the Ottawa Shooting The people spreading this are freaking sick 	rumor
5 people so far have fled Sydney cafe Unknown number of hostages still inside http t co TSrJhOhW15 #sydneysiege	rumor
Photo German Co Pilot Andreas Lubitz who seems to have crashed the #Germanwings flight no purpose http t co 3mSYxvNF3p	rumor
Hostage involved in #SydneySiege texts I'm ok to his mother http t co vcuxBpHCcp http t co lIejfjffN3	rumor
Updated Canadian soldier killed in attack at Parliament Hill in Ottawa http t co tMfDn2GAbh	rumor
Ottawa Hospital says it received 3 patients after shootings 2 stable , wo n't give update on soldier statement http t co aF9HyT9BgX	rumor
How people in France view Muslims Very positively #CharlieHebdo http t co Pkel3P5E26 http t co VmgEstRnAz	non-rumor
Iranian cartoonist for #CharlieHebdo http t co z16ZcwmhUf	non-rumor
Here 's what we know about the #CharlieHebdo attack so far http t co MUwOzTP7kI http t co b8UzO0Gz5W	non-rumor
Paris Manhunt 3 #CharlieHebdo attackers with AK 47 rifles amp reportedly rocket propelled grenade still at large http t co 3Jsosc7yl3	rumor
Charlie Hebdo AFP reports another shooting and hostage taken at grocery in eastern Paris live updates http t co hRyDuB5t0K	rumor
Intolerance cannot be an answer to Intolerance Has to be unequivocal condemnation of the terror attack as well as attacks on Paris mosques	non-rumor
At 87 years of age , Asterix cartoonist Uderzo gets back on the drawing board #CharlieHebdo #DammartinEnGoele http t co 1lNGYsOFvU	non-rumor
How to respond to the murderous attack on Charlie Hebdo \? Every newspaper in the free world should print this http t co sC2ot63F6j	non-rumor
BREAKING #Ottawa Civic Hosp official says TWO NEW PATIENTS are enroute to hospital 1 w gunshot wounds Both stable @ctvottawa #ottnews	rumor
Supermarket hostage takers reportedly threaten to kill if police storm #CharlieHebdo suspects http t co ATmBpjwW3b http t co 4auIDG7ljG	rumor
Soldier shot at National War Memorial in Ottawa http t co Sgmcq7gUzf #cdnpoli #hw	rumor
Mound City Bar Association has agreed to donate their time PRO BONO , for ANY WITNESSES that would like to come forward #Ferguson #MikeBrown	non-rumor
BREAKING Name of co pilot of crashed #Germanwings flight #4U9525 was German , Named Andreas Lubitz http t co yeIsO3yzop	rumor
BREAKING Authorities confirm last words from #germanwings #4U9525 A320 distress call were emergency , emergency http t co wFg8KTSve2	rumor
#CharlieHebdo Love is stronger than hate http t co 23KHz2OsH3	non-rumor
Updated Here s what we know about the gunmen behind the Charlie Hebdo attack http t co armP730CmV http t co OsrH20Cos8	non-rumor
The first person killed in Charlie Hebdo attacks was Muslim police officer http t co 9LUWBZ9SbC http t co ulTAJHywnK	rumor
The worst of times can bring out the best in a lot of humanity Except the super rich #JeSuisCharlie #CharlieHebdo http t co ktqcjTFXPp	non-rumor
Mother of two young children who attend school near #CharlieHebdo site #JeSuisCharlie http t co ntcdVCPSre	non-rumor
Charlie Hebdo mocked Jews Number of people killed 0 http t co 7fjbx0NImn	non-rumor
Canadian parliament on lockdown after shooting live updates http t co PBLZPFqhAP	rumor
We are observing a minute 's silence today at 11am If you support press freedom please share amp join us #JeSuisCharlie http t co RpO4aXd7PE	non-rumor
Paris @UNESCO staff in solidarity with #CharlieHebdo Freedom of expression is a human right http t co HbTz7XM55E http t co M8sTeyu4s3	non-rumor
WATCH LIVE The scene outside Parliament Hill where a soldier has been shot http t co k1d6G8HR0o	rumor
I'm not retweeting the pic of #MikeBrown 's body , but evidently he lost the hat and changed his shoes and shorts And lost 40 lbs #Ferguson	rumor
BREAKING Gunfire and new explosions heard at the site of hostage taking in eastern Paris Reuters reporter http t co 3B69JzccUW	non-rumor
Frank Gardner BBC There are elements of Four Lions here The gunman has the wrong flag He is asking for the ISIL flag to be delivered 	rumor
BREAKING 148passengers were on board #GermanWings Airbus A320 which has crashed in D southern French Alps May protect them AMEEN 	rumor
Have said it before , but needs saying again Stop asking Muslims to condemn terrorism It 's bigoted and Islamophobic http t co 6dzrywffN1	non-rumor
IMAGE @flightradar24 altitude amp speed chart of #4U9525 Aircraft entered a steep but constant descent http t co MoG0h2Dvaq	rumor
#BREAKING 1 dead , several injured in shootout North East of Paris \( French radio @RTLFrance \) http t co LdSF5QeCiv #CharlieHebdo	rumor
And this is Cpl Nathan Cirillo , the brave #Canadian soldier killed in the #OttawaShooting today http t co w9EOyX8MAI	rumor
Black teenage boys are not men They are children Stop referring to a 17 year old as a man You are killing children #ferguson	non-rumor
Helicopters and vehicles are seen next to a building in Dammartin en Goele where a hostage taking is underway #AFP http t co CBBLljNX0K	rumor
I really do n't understand why people in Europe think I'm a 'moron ' http t co NGAuK5XkGZ http t co H8ovSocjcu	non-rumor
A gunman is killed after shooting at war memorial and Canadian parliament in Ottawa , media reports say http t co sj9jOKOw2X	rumor
Germanwings plane crashes in French Alps with 148 people http t co pg3bpbv7R1	rumor
Police say 12 now dead in #CharlieHebdo attack including 2 police officers prosecutor says gunmen still at large http t co 4AaqPAQMOb	rumor
Police confirm 'several' shootings in Ottawa PM safe downtown buildings in lockdown http t co WX22NpkCFs http t co FlvvBW7Cu2	rumor
Editor of Charlie Hebdo has been liberal amp righteous Salute to all the cartoonists martyred at the terrorist attack http t co Yk3PgHkz4S	non-rumor
Report #Ferguson police beat up wrong suspect then charged him for getting blood on uniforms in 2009 http t co kLB4im10qo	rumor
#Canada Soldier shot today MT @megunder On Sunday very handsome guard in picture with my friend RIP Nathan Cirillo http t co qJXlw1hNN3	rumor
 If liberty means anything at all , it means the right to tell people what they do not want to hear #CharlieHebdo http t co QbSEVIFv2X	non-rumor
In this difficult time , People of Iran and their resistance movement stand by people of France and bereaved families #CharlieHebdo #Paris	non-rumor
Extended Video Guns raised , officers rush towards @RideauCentre http t co YHpG2o8XeH http t co UsPYjU85AS	rumor
Pencil sketch tribute #JeSuisCharlie http t co nFESx847MA	non-rumor
Mike Brown was staying with his grandmother for the summer , who lived in the community #Ferguson	rumor
We begin in Paris with a moment of silence for those killed in the #CharlieHebdo attacks http t co KAZQB07OKy http t co XDgW3uXmoF	non-rumor
People gather for a minute 's silence to remember the victims of the #CharlieHebdo attack http t co Fv0ZHWLPQX http t co ElS4WMYyV6	non-rumor
I feel France will throw satire into the murderers faces , and freedom of expression will be ever greater #JeSuisCharlie #	non-rumor
I may not agree with what you say but will defend your right to say it Voltaire #JeSuisCharlie #Libert Dexpression http t co rSbYpPGyfq	non-rumor
Matt 's perfect response #CharlieHebdo http t co GgoX0H0NgY	non-rumor
On Weds Saudi Arabia condemned #CharlieHebdo as 'cowardly attack' Today they flogged Raif Badawi for encouraging free speech 	non-rumor
All who said #JeSuisCharlie this week must today say #JeSuisJuif I am a Jew Stand with France 's Jews against this vile attack 	non-rumor
#France has a problem \( and quite a serious one \) #CharlieHebdo http t co H15l2ARF3d	non-rumor
Dear editors every time your media organization censors a #CharlieHebdo cartoon , you are enabling and justifying mass murder Love , Josh	non-rumor
I would rather die standing up , than live life on my knees #JeSuisCharlie #IamCharlie http t co VekwGbshpq	non-rumor
Breaking News 2 hostage standoffs right now in France 1 involves #CharlieHebdo suspects http t co HlhbTJmm1D http t co CwmrmxLApA	non-rumor
This is not okay #Ferguson http t co hb3jH6GfAt	non-rumor
LATEST Suspected Ottawa gunman identified as Michael Joseph Hall , a convert to Islam also known as Michael Zehaf Bibeau @PeteWilliamsNBC	rumor
Thousands tweeting #JeSuisCharlie in support of #CharlieHebdo http t co GfdXTw6jgl	non-rumor
#CharlieHebdo 11 dead including 2 police in Paris shooting by @MartinBureau1 #AFP http t co T8HpVdpjjN	rumor
Breaking automatic gunfire reported at Montrouge near Paris Gunmen escaped in metro , say French reports http t co 2J4WQdJnTp	rumor
RT @LucilleClerc Break one , thousand will rise #CharlieHebdo #JeSuisCharlie #raiseyourpencilforfreedom http t co j6eGzOB6lk	non-rumor
France , turning on your own Muslim citizens amp blaming Islam for #CharlieHebdo feeds the extremists' agenda Do n't help them 	non-rumor
It took the police 5 days to concoct this tale and this is what they came up with \? #ninjaplease #ferguson	rumor
The artist behind this iconic #CharlieHebdo pencil tribute http t co qDdyz2cS8D http t co UrTJu7Pkbd	rumor
This is what courage and duty look like #CharlieHebdo http t co aKVE7buqcQ	non-rumor
Chief Jackson initial contact between officer and #MikeBrown was not related to robbery #Ferguson	rumor
And I'm now officially done with @Uber , which is price gouging during AU hostage crisis What sad sorry clowns http t co OTwTz3E8UM	rumor
BREAKING Suspects in #CharlieHebdo shooting still free and heavily armed , French Prime Minister says http t co ecqWtDAaqc	non-rumor
Cartoonists do n't deserve death for artwork But I am not #CharlieHebdo Their racist content does n't become courageous because ppl died 	non-rumor
 I strongly condemn the horrific shooting at the offices of Charlie Hebdo magazine in Paris President Obama http t co qr9zeGU04o	non-rumor
Update French interior ministry says incident which led to evacuation of Trocadero near the Eiffel Tower in Paris was a false alarm	rumor
Paris , London , Madrid , San Francisco , New York Video footage from #JeSuisCharlie gatherings around the world http t co IDEN8LHSEE	non-rumor
Pens aloft UK MPs , peers and Parliamentary staff stand in solidarity with the people of France #JeSuisCharlie http t co ztJPZedJB7	non-rumor
 ! ! #Ferguson cops once nabbed wrong man but charged him w property damage for bleeding on uniforms they had beat him http t co p5TRiQtWFY	rumor
LIVE REPORT Assault in Paris \( #Vincennes \) Some hostages are free http t co umff4LVVJL #CharlieHebdo http t co tAtUcfI5pc	rumor
Leafs Sens game postponed after shootings on Parliament Hill http t co 19SAtvFFKT	rumor
If you are not condemning the #Islamic ideology that killed 12 at #CharlieHebdo , your sympathy does n't mean shit Support #FreeSpeech 	non-rumor
Everyone take a moment to honour Cpl Nathan Cirillo the fine solider that was killed in Ottawa today #Hero http t co UXb3CxWGZ2	rumor
Policeman seriously injured in new #Paris shooting as seven arrests made live updates http t co cCc9GdG3HV http t co JqhZChVPCw	rumor
How Parisians responded to the #CharlieHebdo attack http t co O1qrPOGOJ1 http t co KnnfELpPM6	non-rumor
 I do not agree with what you have to say , but I 'll defend to the death your right to say it Voltaire #CharlieHebdo	non-rumor
Charlie Hebdo Don t blame this bloodshed on France s Muslims Nabila Ramdani http t co XZlutySyZn	non-rumor
In solidarity with all the journalists pursuing their profession and freedom of speech #CharlieHebdo http t co n7WSJsf0Si	non-rumor
Take a break from bashing Cheney and waterboarding Possible ISIS terrorist attack ongoing in Sydney http t co nkksw4ozE2	rumor
The moment a female Lindt worker escapes the #SydneySiege http t co isvMtY4oUQ #hostage #MartinPlace http t co iAlARm6GRf	rumor
And this , if you 're not #CharlieHebdo saturated http t co CkGBxkIyfD	non-rumor
Michael Brown was due to begin classes at Vatterott College tomorrow His mother mourns his loss #Ferguson http t co YMSK7Skp9y	non-rumor
France is in shock after brutal attack on satirical newspaper #CharlieHebdo http t co tOtJeEAUJ7	non-rumor
An 88 year old woman has joined the youth in #Ferguson http t co dfDid2xV8X	non-rumor
BREAKING NEWS Ottawa police confirm at least 3 separate shooting sites and multiple suspects http t co lXFiYaVImZ	rumor
Western double standards hit a new low following #CharlieHebdo By cartoonist @LatuffCartoons http t co cvuwTFU7XY	non-rumor
Let 's get these cameras on cops everywhere #Ferguson http t co u89uNkNGoS	non-rumor
Tonight 's game between Maple Leafs amp Senators has been postponed after shootings in Ottawa this morning http t co OXpRxAjwCE	rumor
The Ottawa Hospital now says all three patients involved in today 's incident have been discharged http t co 24l1f58UPx #OttawaShootings	rumor
Banksy 's illustrated response to the Charlie Hebdo attack is n't by Banksy But it is striking http t co NQueBlmfOt http t co HedHlyB24X	rumor
#JeSuisCharlie They 're only cartoons , or am I also prone to being killed for posting them http t co f0bWALfCPl	non-rumor
RT @khjelmgaard German media reporting #AndreasLubitz had a 'serious depressive episode' six years ago http t co MUdmHPz2ro #Germanwings	rumor
I 'd never seen Charlie Hebdo magazine or it characterisation of Muhammed until today Now it 's everywhere Smart move ya dumb fuck fanatics 	non-rumor
Black flag held by #Sydneysiege hostages bears Islamic message of faith http t co rEpn2Mt4UC \( PHOTO AP Channel 7 \) http t co U9sqDmwt4w	rumor
I instantly broke down crying and scared for my own life These officers do NOT care about me or anyone black #Ferguson #MikeBrown	non-rumor
Tanks Military police Occupation Media blackout No fly zone In a suburb This is America in 2014 #Ferguson	non-rumor
Live video from standoff north of Paris with brothers suspected in the Charlie Hebdo attack http t co mPaB3pGQdA http t co 1MU2eqChai	non-rumor
#BREAKING A #Germanwings Airbus A320 plane has crashed in southern France , police and aviation officials say 	rumor
Ugh Uber introduces 100 minimum surge pricing during #SydneySiege http t co 9YZ9WKo7D2 via @jennijenni http t co 9Xk76P4S3V	rumor
Ottawa Police wo n't say if there are still suspects at large say it is still an active operation live video http t co aF9HyT9BgX	rumor
As someone raised Muslim , senseless bloodshed in my name is far more offensive to me than any cartoon can ever be #CharlieHebdo	non-rumor
Parliament was stormed by at least one gunman who shot a soldier standing guard at Canada 's war memorial #cbcOTT #OTTnews	rumor
RT @tabithalou This what they not showing you on the media These young men cleaning up after the riot #Ferguson http t co 50AjPG6o3V	non-rumor
A @germanwings A322 #4U9525 , BCN DUS , with at least 143 passengers has crashed today at 9 39 UTC http t co L7Wtodurt7	rumor
Oh God my heart is sick at this Charlie Hebdo news One of the only brave newspapers in the world 	non-rumor
PAY ATTENTION as teen becomes man , community becomes mob , and murder becomes alleged shooting #Ferguson #medialiteracy	non-rumor
Angela Merkel condemned the #CharlieHebdo attack on freedom of speech and the press Obama did not Shameful 	non-rumor
Yes this is about victims It 's also about how our communities reform amp abolish blasphemy codes We must n't run from scrutiny #CharlieHebdo	non-rumor
#CharlieHebdo the magazine will be published next Wednesday as usual says magazine lawyer Print run 1 million copies 	non-rumor
Q why did he stop Michael Brown \? #Ferguson Police Chief because they were walking down the middle of the street blocking traffic 	rumor
happening now in #ferguson https t co MYPxUyo7Xx	non-rumor
So a large Negro robbed a store and then the cops saw a large Negro WHAT WERE THEY SUPPOSED TO DO \? ! \? ! Perhaps not execute him #Ferguson	rumor
Charlie Hebdo Norway didn t give in to Islamophobia , nor should France Owen Jones http t co gWCVwwFTWr	non-rumor
British press publish horrifying photos of police officer being murdered but not Charlie Hebdo cartoons Strange values #JeSuisCharlie	non-rumor
Man urinates in the mosque ! Prophet asks to let him to finish , then wash it away Then sits and calmly explains to him #CharlieHebdo	non-rumor
If true that the #CharlieHebdo magazine attackers met their fates at a printing shop well then the rest of this tweet writes itself 	non-rumor
Reportedly 3 hostages have come out of the #lindt cafe #sydneysiege	rumor
The problem isn t Islam The problem is assholes Every religion has em #JeSuisCharlie	non-rumor
While horrified with #CharlieHebdo , let 's not forget #RaifBadawi 50 lashes today in Jeddah , first batch of 1000 ! ! \( http t co l8ACRZuhVZ	non-rumor
#SYDNEYSIEGE Contact made with gunman police report http t co H0SlBNPHG6 http t co 1ZlzKDjvSf	rumor
At least 72 Germans and 35 Spanish killed in #Germanwings crash Airline http t co JeigmQOTna http t co HrECGvkUuV	rumor
BBC News Sydney siege Hostages held in central cafe http t co TaSZx5PnEz #sidneysiege	rumor
Bottom line cops are supposed to use deadly force only when lives are at risk You do n't shoot robbery suspects #Ferguson	rumor
Shoot unarmed kid Conceal evidence Impose martial law Harass reporters Smear the victim Worst Police Ever #Ferguson #MikeBrown	rumor
Powerful amp harrowing image of a Lindt workers escaping the #sydneysiege https t co NltzGnXezS	rumor
So would that angry mob in #Ferguson also qualify as concerned citizens \? What 's the difference , skin color \? #justice4all	non-rumor
Sergeant at arms Kevin Vickers who reportedly shot suspect hailed as hero http t co CmAVz7UYMN #ottawashooting http t co GNJAq4fWTN	rumor
Crowd gathered at Union Square in NYC right now to memorialize those killed in #CharlieHedbo attack #JeSuisCharlie http t co SusW1OnvlT	non-rumor
Oh , and the cover of today 's edition of Charlie Hebdo mocked Michel Houellebecq for writing an Islamophobic novel http t co moLfdEMlpM	non-rumor
Recovered black box shows a pilot was locked out of the Germanwings cockpit before the crash http t co ac6AdA5NKL http t co bxgMNjEGeW	rumor
The victims of the #CharlieHebdo attack http t co v8Cw7N58B0 http t co yVgnrLa7vk	non-rumor
A while ago , I Tweeted this #CharlieHebdo cover mocking the British I do n't remember anyone threatening violence http t co 28Z2jmTV5I	non-rumor
The Pen Is Mightier Than The Sword 28 Cartoonists Pay Tribute To Charlie Hebdo Victims http t co sSfQMaSviI http t co 0nOThrr8VX	non-rumor
These cartoons are poignant tributes to victims of the Charlie Hebdo attack http t co R59wUj58Pp http t co 5BhfsdNYfe	non-rumor
BREAKING #Paris is exploding with support for #CharlieHebdo #ParisShooting http t co hMROBwtwRI	non-rumor
An explosion has been reported near a mosque in Paris Updates http t co pmS6OiSh40 #ParisShooting #JeSuisCharlie http t co NiglsAQGwM	non-rumor
Charlie Hebdo 's Nov 2011 CHARIA HEBDO guest edited by Muhammad 100 lashes of the whip if you do n't die laughing http t co 5EzG448CNm	non-rumor
Google pushes cash to Charlie Hebdo but not Al Ikhbariyah What 's is Google 's view of the world \? http t co ANTlKCmDe6	non-rumor
A Germanwings Airbus A320 , flight #4U9525 BCN DUS , crashed in southern France 148 on board http t co tUtpc26daX	rumor
LATEST Numerous gunmen involved in #Ottawa shooting attacks , manhunt is on police spokesman http t co Zp9AKplH9p http t co hji1netpU8	rumor
We stand united with the victims of the brutal attack in Paris and with the people of France ! #JeSuisCharlie RT ! http t co mH5l2a9eVy	non-rumor
All Muslims are not like that Okay \? RT @DrShobha The co pilot of the Germanwings Airbus was a convert to Islam	rumor
Unconfirmed reports gunmen asked for people by name before killing editor and cartoonist http t co 26GC840I9k #CharlieHebdo	rumor
Total 5 hostages have left Lindt #MartinPlace 3 men , 2 women LIVE http t co Ni4ouWAGoO #SydneySiege #9News http t co CKB2uLPHVd	rumor
Five hostages have escaped the besieged Lindt Cafe in #Sydney Our latest update http t co XJVICQdu0y http t co aNGBZsCmdQ	rumor
Store owner told @FOX2now Monday that there was a theft , but said it was not MichaelBrown said it was someone else #Ferguson	rumor
This would help tremendously #mikebrown #Ferguson http t co FNVnuZLWd1	non-rumor
Australian Mufti condemns hostage taking in #Sydney Statement #SydneyHostageCrisis #SydneySiege #SydneyCafe http t co n38XZVq5iu	rumor
#BREAKING Paris supermarket hostage taker 'neutralised' security source	rumor
Ottawa police and RCMP will be announcing a joint press conference time shortly #cbcOTT #OTTnews	rumor
 17 journalists massacres by Israel in Gaza , 2014 Where were these freedom of speech people then \? #CharlieHebdo http t co ASd3jbRwRQ 	non-rumor
Charlie Hebdo magazine is planning a print run of its next issue of a million copies , not usual 60 , 000 Expected to sell out #wato	non-rumor
The Lindt store refuses to be halal certified perhaps thats why they were targeted #jihad #Sydney #hostagecrisis http t co gAEf9aHB8v	rumor
When free speach die , we die All thoughts to #CharlieHebdo who on this issue wrote Love is stronger than hate http t co IizcmJJVOD	non-rumor
The police in #Ferguson are using military suppression tactics on unarmed civilians That 's not law enforcement , b 	non-rumor
#France 's most famous cartoonist , 87 year old Uderzo father of Asterix comes out of retirement for #CharlieHebdo http t co q85uWyqC5F	non-rumor
B Z , Berlin 's biggest paper stands up by putting multiple Charlie Hebdo cartoons on its cover , including Proph Mo http t co c3LiE3dgeo	non-rumor
#CharlieHebdo 11 dead including 2 police in Paris shooting Photo @MartinBureau1 #AFP http t co xkczbYS82E	rumor
 Female Islamist terrorist attacks Paris Jewish store As a woman , she has equal rights only when it comes to murdering nonbelievers 	non-rumor
Our vantage point on the gunfire and explosions in Dammartin http t co 27X1BRVn8Y	non-rumor
DEVELOPING Police pursuing #CharlieHebdo shooting suspects , helicopters deployed LIVE FEED http t co GRxHibEau2 http t co pDlmmCax1B	rumor
Reports now that 2nd shooter has been shot in downtown Ottawa #ottnews	rumor
My heart goes out to the victims of GermanWings crashed near Marseille , France 142 passengers , 6crew all feared dead http t co 8HbQacJ3id	rumor
 They say we destroying our own neighborhood We do n't own nothing out here #Ferguson http t co cVqf6kYkUL	non-rumor
UPDATE People in Sydney 's CBD buildings surrounding Martin Place have reportedly been told to evacuate #9News https t co A9hv53XqBS	rumor
#sydneysiege Up to 20 hostages are being held in darkness in a cafe in Sydney http t co 5jtd36wFOU http t co Gmt7PAuHzb	rumor
Banksy says #JeSuisCharlie in a beautiful way \( vi @lukeeve \) http t co GKFP5xVAoc	rumor
In 2009 #Ferguson PD beat a black man , then charged him for getting blood on their uniforms http t co Y1QTm1BZyt http t co KcuZ5VFMOn	rumor
This cartoon by Robert Mankoff from The New Yorker Sept 2012 #CharlieHebdo http t co pyQfnV42Su	non-rumor
The best cartoon yet about the #ParisShooting #CharlieHebdo #JeSuisCharlie http t co 8GJk1mOjNu	non-rumor
RT @ westwest yall Never forget the original relationship between the police and blacks #wearetargets #Ferguson http t co Hbd4J61Va7	non-rumor
If you kill men for making fun of your ideas , you need to rethink your ideas #JeSuisCharlie	non-rumor
Siege at Sydney 's Martin Place has now been underway for an hour Hostages remain inside http t co mmOH7zakyB http t co VAghE9YLm3	rumor
In Paris on the eve of the Jewish Sabbath women and children are taken hostage in Kosher grocery store Jihadis hate Jews and journalists 	non-rumor
JUST IN 2 women have just run from Sydney cafe during ongoing hostage situation @9NewsAUS http t co n5vhI5DsZg	rumor
'Charlie Hebdo' editor killed in Paris terror attack built career on defiance http t co T6VqPcerWe	non-rumor
Police and protesters face to face in #Ferguson http t co C0U0rQzGFa	non-rumor
Paris reports that man suspected of killing policewoman has 5 hostages at kosher supermarket http t co ZuU5xaf25I http t co DVYPLL3XbF	rumor
Surviving Charlie Hebdo staff say they 'll publish next week , with 1m print run http t co I5j0QKEZHX	non-rumor
UPDATE Reports gunman says four devices are located around Sydney Security response underway Police calling for calm #9News	rumor
call me foolish but this girl holding #JeSuisCharlie hiding her face , in a ghostly looking #Aleppo #Syria made me cry http t co bFGf3edOAu	non-rumor
So the angel Michael Brown who is 6'4 290 is the robber of the convenience store ! #Ferguson http t co d81cQPHzbi	rumor
RT @rolandsmartin This is simple IF #MikeBrown was a robbery suspect , why didn t #Ferguson police say that on DAY ONE \? Why wait six days \? 	rumor
Al Qaeda added #CharlieHebdo editor to Most Wanted List for publishing Prophet Muhammad cartoons http t co VrMJ6AXDrt	non-rumor
 NOT AFRAID Thousands in France gather to a send message after Charlie Hebdo attack http t co i4iNC9hLs3 http t co IgiP5dkW1g	non-rumor
Police Shooting in southern Paris wounds French police officer too early to draw connection between this and Charlie Hebdo attack @AP	rumor
Yet another hostage has just been forced by the gunman to call the @9NewsSyd office passed on his captor 's demands #SydneySiege	rumor
Salman Rushdie I stand with #CharlieHebdo , as we all must , to defend the art of satire , which has always been a force for liberty 	non-rumor
Cartoonists Georges Wolinski and Cabu are among victims of attack on #CharlieHebdo in Paris http t co EJ0gGFsRZ1 http t co 42xHoEocru	non-rumor
Man compares the Prophet to a dog ! He prays for his forgiveness has him buried in his own cloak , and prays upon his funeral #CharlieHebdo	non-rumor
Seven people reportedly taken away on stretchers , with paramedics treating five #SydneySiege http t co mZ1o7Bi9kC http t co QLsWpHSJTM	rumor
Sergeant at Arms of Canada 's parliament called a hero for shooting gunman who entered building http t co n7Uyuj8zgu http t co kfV2La0M7m	rumor
RT to fuck terrorism http t co 7SHjMeJ0iD http t co TSMMnxz0Ya	non-rumor
Even if #MikeBrown was running down the street with a bag full of boosted goods , he deserved a trial Not a street execution #Ferguson	rumor
Soldier shot dead in #Ottawa today is Cpl Nathan Cirillo Reservist was based in #Hamilton , Ont 	rumor
SYDNEY HOSTAGE CRISIS http t co HFW40OyVUz	rumor
'Attack on media World community ca n't allow extremists to silence free flow of opinions , ideas' Irina Bokova of @UNESCO #JeSuisCharlie	non-rumor
ALERT France 's transport minister says distress signal was sent from Germanwings plane @patthomas , @europe1 http t co Ni7bJyJ52i	rumor
Police search gas station where French media reported #CharlieHebdo suspects allegedly were seen http t co v9cuXpPIYF	rumor
Cartoonist promises to draw Mohamed every day for the rest of the year #CharlieHebdo http t co FLxOuc7MA9 http t co Gxk5jwgkyv	non-rumor
This is what they are n't showing you on the media These young men cleaning up after the riot #Ferguson http t co eDH53pfQyg	non-rumor
Banksy #JeSuisCharlie http t co 8w3m2CX96n	rumor
BREAKING GermanWings A320 Crash in Southern France	rumor
Solidarity with Charlie Hebdo http t co gvLp0NwLax	non-rumor
 Do n't shoot ! Do n't shoot ! #ferguson https t co PhairpOfdl	non-rumor
The @NewYorker cartoonist 's response to the #CharlieHebdo attack http t co uxDrVwl4M3	non-rumor
Police murder another unarmed 17 yr old blk kid amp police show up like this I ca n't take it ! #Ferguson #WeAreTargets http t co RuZ8YAgGPr	non-rumor
10 28am Charlie Hebdo account mocks ISIS leader , wishing him good health and best wishes http t co 9Oa2xAqOcM http t co uYXayKLA7q	non-rumor
Gunshots and explosions heard in #Dammartin http t co LdSF5QeCiv http t co VoqNdOeYfm	non-rumor
#breaking We have now heard that all airspace in the #Sydney city has been shut down #martinplace #Lindt cafe http t co GH9K75afmR	rumor
Thank God he 's not a Muslim ! Otherwise the world 'd be on a Muslim hate spree now #Germanwings http t co NoXAhjSmP7 http t co Qdsc50p86W	rumor
Police Negotiators are now in contact with armed hostage taker in Sydney situation motive remains unknown http t co mp18E4DdjW	rumor
Ottawa police confirm 1 male shooting suspect died no one in custody @OttawaPolice http t co 9emMsGE1FZ	rumor
Muslims are not terrorists #prisedotage #Dammartin #ContreLesTerroristes #AtentadoParisEP #JeSuisCharlieARV http t co 8LBo8XCKQU	non-rumor
Some Leaf players say they heard shots this morning from the Tomb of the Unknown Soldier Scary events in Ottawa	rumor
University of Ottawa is in lockdown , classes are cancelled	rumor
2 hostages in Sydney caf confirm to @channeltennews gunman 's demands 1 \) He wants ISIS flag delivered 2 \) He wants to speak to Prime Minster	rumor
#CHARLIEHEBDO SHOOTING Gunmen still at large , manhunt underway LIVE UPDATES http t co 3Jsosc7yl3 http t co LzCuCBqQP8	non-rumor
Police car with bullet holes in front of Charlie hebdo headquarter Photo @WilliamMolinie http t co k6inhBmGsf	non-rumor
Memo to @ron fournier you owe @jimgeraghty an apology GERMAN NEWS Co Pilot of Germanwings Airbus Was MUSLIM CONVERT	rumor
11 dead as shots fired at French satirical weekly #CharlieHebdo Photo Philippe Dupeyrat #AFP http t co q38epI1b8b	rumor
Today , the whole world is Charlie \( via @diklo69 \) http t co vOuXCrsPKq #JeSuisCharlie	non-rumor
#WakeUpAmerica Co pilot was a Muslim Convert http t co RYFQTVBYBL @seanhannity @greta @act4america @KrisParonto @JGilliam SEAL	rumor
BREAKING Canada police investigating Michael Zehaf Bibeau as possible suspect in Ottawa shooting source familiar with matter	rumor
The #CharlieHebdo massacre brothers have been killed Full story here http t co s7KfpU7vqb http t co jFCrKaZ3DL	rumor
1st person killed by terrorists was a French Muslim cop , RIP Ahmed Merabet Bigotry is ALWAYS wrong ! #CharlieHebdo http t co yyitubfAIt	rumor
The world now knows his name , tonight get to know Mike Brown the person @fox2now at 9 #ferguson http t co jBNenRkexL	non-rumor
We are monitoring police operation going on right now in #Reims , France Latest on #CharlieHebdo attack on #AC360 8p http t co niJKHosLpm	non-rumor
Julian Assange has lost the plot Blames Jewish pro censorship lobby for legitimizing the Charlie Hebdo massacre http t co QZClfKB6ZH	non-rumor
US consulate in #Sydney reportedly evacuated amid ongoing hostage situation at chocolate shop http t co n4D3yGjso9 http t co ayL7vvqxl8	rumor
REMINDER #MikeBrown was a kid who just wanted to walk down a street And for that , HE IS DEAD Those are the facts #Ferguson	rumor
BREAKING Paris police Market gunman threatens to kill hostages if police storm terrorist brothers 	rumor
LATEST At least 11 dead in shooting at French magazine #CharlieHebdo France raises terror alert to highest level http t co JVRjF5b1lw	non-rumor
Hostages held in Sydney cafe , Islamic flag seen in window local TV http t co BF78HpFgWh	rumor
Lots of angry mothers here in #Ferguson this morning http t co RXTdkGgDMG	non-rumor
RT @australian Siege situation currently unfolding at Sydney 's Martin Place Updates here http t co YqJWqhN5rR http t co bBPh9ds8H1	rumor
#MikeBrown , left , is gunned down for WWB \( walking while black \) , but guy on the right can point a gun at cops #Ferguson http t co ydAVrBLQke	non-rumor
Charlie Hebdo Norway didn t give in to Islamophobia , nor should France http t co zOecdkUL41 @owenjones84	non-rumor
Anybody who wants to talk about what Charlie Hebdo might have done to provoke this should probably shut up , forever 	non-rumor
Remembering the four French Charlie Hebdo cartoonists killed in terror attack today http t co nv5A2qKNQN http t co TZovXRJpVp	non-rumor
 I saw one of the soldiers laying on the ground Witnesses depict chaos in #OttawaShooting http t co VeZxrHnPCd http t co 1hhIi1ykh2	rumor
FM #Steinmeier on #CharlieHebdo attack Abominable act of terror against the free critical press is an outright assault on European values 	non-rumor
Best response to the #Islamic terrorists who attacked #CharlieHebdo , is to republish their cartoons over amp over again http t co 36GqZUbvwB	non-rumor
Happening now in #Ferguson where #MikeBrown was killed http t co LfN0DWYp0B	non-rumor
 Even if they kill 10 of us , the newspaper will go out next week #CharlieHebdo http t co m4slfkJ3xJ http t co fHR1vPffz2	non-rumor
The two suspected #CharlieHebdo gunmen have been killed , according to reports #ParisAttacks http t co sS4Js4JZwm http t co 04KSGEeu5i	rumor
One of my favourites , particularly relevant right now #CharlieHebdo http t co dKHOOqPJIL	non-rumor
BREAKING French police descend on town where gunmen resembling suspected #CharlieHebdo attackers hit gas station http t co pEFLi4EjX0	rumor
 To kill someone for making fun of you is a tacit confession of your own impotence http t co M8UXYm5N4e #CharlieHebdo #JeSuisCharlie	non-rumor
88 year old Creola Mccalister has joined the youth in #Ferguson http t co dfDid2xV8X http t co potRilWqvb	non-rumor
Hero @affanchowdhry Kevin Vickers , head of security in parliament , being credited for taking down shooter #Ottawa http t co rVYetE0KYq 	rumor
Depressing that ppl do n't realise most victims of Islamic extremists are Muslims but I'm relieved @OwenJones84 does http t co rv2VVTrVWl	non-rumor
French police release pictures of two suspects described as armed and dangerous More http t co 2J4WQdJnTp http t co kYNwo7GlgQ	non-rumor
Police told protesters to get out of street , they instead got on knees and said , Hands up ! Do n't shoot ! #Ferguson http t co XFpEsXBwM3	non-rumor
PARIS HOSTAGE SITUATIONS At printing house Holding 1 hostage At kosher supermarket Holding 6 hostages Stay with @PzFeed for the latest	non-rumor
Kill them amp when you 're done kill their pet goat RT @sammy2168 @jjauthor @FlyoverCulture @DrMartyFox http t co 0oTaUVvisg #CharlieHebdo	non-rumor
I'm uneasy with the portrayal of Charlie Hebdo as magazine that provokes No , it publishes cartoons People choose how they react to that 	non-rumor
Hostages held in Sydney cafe , forced to hold Islamic flag in window http t co UiqFQ372Ae http t co LDeKQuLYcx	rumor
Breaking News Reports of Gunfire and Hostage in Search for Suspects in Paris Attack http t co U8BE162qls	rumor
GERMAN NEWS REPORT Co Pilot of Germanwings Airbus Was MUSLIM CONVERT Hero of Islamic State \? http t co Pw2kxje31m via @gatewaypundit	rumor
Our statement on the Charlie Hebdo attack defend freedom of speech , resist hatred https t co 1Ok61nfRwj	non-rumor
Charlie Hebdo will publish one million copies next week with help from Google http t co e1TKBbVpwl http t co 1ThluwbhVq	non-rumor
Shooting , hostage situation reported in eastern Paris' Porte de Vincennes area , prosecutor 's office says http t co 7Bxdhozq4H	non-rumor
Satire is a symptom of a healthy society and always a prime target for fundamentalism There is no 'right not to be offended' #CharlieHebdo	non-rumor
Uber criticized for off the charts surge pricing during hostage crisis in Australia http t co OgTn7iAO1W http t co qdX0m3uzWc	rumor
A good summary via @AntonLaGuardia #JeSuisCharlie #CharlieHebdo http t co 938GZ4T6d3	non-rumor
According to Seven , this is a picture of the gunman http t co 3Zor3gSOSO	rumor
DEVELOPING Shooting suspect at large inside Canadian Parliament reports http t co hU0OfoOGEC http t co 5fkHcPaK97	rumor
 for a cover up to be successful you must first discredit the victim #Ferguson	rumor
Killing of policewoman in Paris linked to #CharlieHebdo killers , police tell French media after identifying suspect http t co vMD7kvcrjr	rumor
2 of the 4 police departments rampaging through #Ferguson were trained by Israel in methods of domination and control http t co ztZUZpzHJb	rumor
Pope Francis prays for gunmen who executed 12 people at #CharlieHebdo http t co sMtOVXT8I9 http t co J2bdIq2k2V	non-rumor
Hostage taker in Sydney cafe demands ISIS flag and call with Australian PM , Sky News reports http t co a2vgrn30Xh #sydneysiege	rumor
Map showing the location of the #CharlieHebdo offices and the direction the attackers fled http t co N28zmSCwVV http t co q9EYxtcjJy	non-rumor
UPDATE Cop fatally shot as France hunts #CharlieHebdo massacre suspects http t co DIw8C6Ng1s http t co Rhfb6vC84P	rumor
#Sydneysiege ends with shootout leaving two dead and more injured http t co vsG9BlxKOk	rumor
#OttawaShooting @RCMP Nat Div press conference will be held at 2 pm today	rumor
Police say shots fired at 3 #Ottawa sites National War Memorial , Parliament Hill , and now Rideau shopping centre http t co rOnqpUbuqc	rumor
Gunman at Paris grocery store threatens to kill hostages if police storm the #CharlieHebdo brothers http t co EBbK7ny8Cx	rumor
Eiffel Tower went dark last night in tribute to the victims of the #CharlieHebdo attack http t co zG9jA7M6Kb	non-rumor
More police arrive at hostage situation scene in eastern Paris \( LIVE \) http t co fN6v7h6iBP http t co saSZitkznh	non-rumor
#CharlieHebdo RT @JeffreyGoldberg The gunmen 's basic message If you do n't stop calling our religion intolerant amp violent , we 'll murder you	non-rumor
Tracking data shows descent of #4U9525 was very aggressive , but not full freefall \( image via @planefinder \) http t co vV6LPavase	rumor
#BREAKING Soldier shot in the Canadian capital of Ottawa and a gunman is believed to have entered Parliament http t co 3DWYnF22aI	rumor
Uber Is Allegedly Charging Passengers 100 Minimum During Sydney Siege http t co 6GYtqylMUt via @braddybb	rumor
An estimated 6000 Jews left France last year and the international media paid no heed http t co IzKjXRsyJd	non-rumor
Michelle Stanistreet , general secretary of the National Union of Journalists \( UK \) on the #CharlieHebdo attack http t co L0uUdPmswx	non-rumor
French PM says passengers and crew of Germanwings plane that crash feared dead http t co on24GtCYyv	rumor
BREAKING Dozens of shots fired in Canada 's Parliament after gunman entered main door , Ottawa journalist says http t co qsAnGNqBEw	rumor
17 journalists massacres by Israel in Gaza , 2014 Where were these freedom of speech people then \? #CharlieHebdo http t co jcFNEXmH4a	non-rumor
UPDATE Gunman in kosher grocery store is demanding the release of the suspects in #CharlieHebdo shooting Reports http t co 1Y123fisl2	rumor
PHOTO Police release this photo of a man they believe has taken at least five people hostage in a Paris market http t co 8UZpTcLqUn	non-rumor
Gunman demands meeting with Tony Abbott and claims four bombs in area #sydneysiege http t co F5QXAWZM3w http t co Uam9VUm9fh	rumor
Hostages Held In Sydney Chocolate Shop Forced To Hold Up Islamic Flag http t co HFOY0ctLNV https t co E4mPEUMATs	rumor
Total number of people who have left the cafe in Sydney up to 5 The latest http t co Nl3BNlFidA #SydneySiege http t co TgZkYFNlR9	rumor
#Paris update 3 Multiple mosques attacked in France after #CharlieHebdo http t co bvWHrN4Q7y via @mashable http t co 7PiVltMrbR	non-rumor
#BREAKING Flag w Islamic writing held up to window of #Sydney cafe Police say up to 50 hostages #Australia PM convenes security team 	rumor
#OTTAWA FOOTAGE Video captures moment shots fired in Canadian Parliament http t co Zp9AKplH9p http t co CkAO04v5gm	rumor
Uber backtracks , offers free rides after prices were gouged for people fleeing from Sydney hostage drama http t co cSIT4JaCjk	rumor
My heart is with Paris amp all affected by this tragedy #CharlieHebdo #JesuisCharlie #freedom Image @lucilleclerc http t co T0bszBkgCP	non-rumor
Spread this cover in solidarity with the victims at Charlie Hebdo Do n't let the sword conquer the pen http t co XVkPPbkLhn	non-rumor
PHOTOS #Ferguson , Missouri , looks like a war zone http t co wXClUFvfXH http t co X0ScvTtUA2	non-rumor
Smoke , gunshots reported at site of standoff with suspects in the attack on Charlie Hebdo http t co LDp3chB8FY http t co IuAaEnrlXv	non-rumor
To all my friends in France Paris JE SUIS CHARLIE #JeSuisCharlie JB http t co v07hiS7AyO	non-rumor
Shooter still on loose after uniformed soldier shot at #Ottawa 's War Memorial , across road from Parliament MP 's being taken out of offices 	rumor
Did you hear about the #LoveBomb by British Muslims at French Embassy London yday \? #CharlieHebdo @mrjamesob @LBC http t co 0439amYA3m	non-rumor
142 PEOPLE ON BOARD GERMANWINGS AIRBUS A320 THAT CRASHED IN SOUTHERN FRANCE	rumor
 You tell the media it was al Qaeda in Yemen reported words of #CharlieHebdo attackers Read more http t co qDPrycGtAR #c4news	rumor
RT @froomkin #CharlieHebdo s Charb I would rather die standing up than live on my knees http t co cGlB7C9tZ2 http t co RjjZm3r6gb	non-rumor
Latest pictures from hostage situation at a kosher grocer in the French capital #ParisAttacks http t co zZIgbWOmcP http t co 5DkRZ2szYx	non-rumor
A witness describes the use of tear gas tonight #Ferguson http t co B6vi7M10ck	non-rumor
#Ferguson #MikeBrown protests http t co UubTxFmU7c	non-rumor
Raptors hold a moment of silence to honour Cpl Nathan Cirillo and all those affected by today 's events in Ottawa http t co hqoIIvCRNj	rumor
New York Times Square #JeSuisCharlie http t co QneXYbY0Bt	non-rumor
The police officer who killed Mike Brown has been put on paid administrative leave #Ferguson	non-rumor
Pray with me for those being held hostage right now in Sydney And for the police and those responsible May peace prevail	rumor
 http t co Jz4Lrp0eZb 433 Charlie Hebdo shooting World leaders condemn attack in Paris #CharlieHebdo Masked gunm http t co ULH3Vt3TG8	non-rumor
Reports on @channeltennews #sydneysiege gunman wants #ISIL flag delivered to cafe and he also wants to speak to PM or people will be killed 	rumor
I'm so disgusted #Ferguson RT @ZandarVTS This has now devolved into the worst police shooting cover up attempt in US history 	rumor
please repost this and stay out of Sydney on New Years , better safe than sorry ! http t co hh0PHk55Ps	rumor
BREAKING Germanwings co pilot was Muslim convert http t co iCRwOsU1uq	rumor
Report #Ferguson cop identified as unarmed teen 's killer skipped town days ago http t co 5GQvgcw3LJ	rumor
BREAKING CTV News confirms that shots have been fired on Parliament Hill 	rumor
BREAKING #Ferguson police have identified Darren Wilson as the cop who shot and killed Michael Brown More details to come 	rumor
BREAKING #CharlieHebdo Terrorists Attended Radical Mosque in Paris http t co oEvVOOHRqh #JeSuisCharlie http t co 78vtE2Jv3J	non-rumor
This http t co yAKOt5aARE #JeSuisCharlie http t co hUYhnDDBSf	non-rumor
 @mrjamesob gave a masterclass in dealing with people who demand an apology from Muslims for #CharlieHebdo attack http t co 4y9oBXtwvf	non-rumor
Today 's #CharlieHebdo cover on Houellebecq In 2022 I 'll observe Ramadan http t co G7zbitA3Cj	non-rumor
#Breaking The officer involved in the shooting of Michael Brown is named Darren Wilson , #Ferguson police chief says 	rumor
Hostages seen fleeing from cafe at centre of #SydneySiege moments ago http t co nM2pss0I9d http t co MXGOxDGdwv	rumor
Short piece from me on why no one is to blame for #CharlieHebdo murder but the murderers themselves http t co XkrzPFPhRl	non-rumor
Police shootout ends 16 hour siege in Martin Place #sydneysiege http t co OoutIlaTo6	rumor
#BREAKING At least five hostages in Paris kosher supermarket \( AFP \) https t co h1qXZG6GlP #Vincennes http t co NYRdp3n1lT	rumor
Here 's the police report Somehow #Ferguson cops valued a box of Swishers at nearly 50 Time to stop smokin I guess http t co 8ZkvrHkApc	rumor
BREAKING 148 feared dead in crashed #Germanwings flight http t co bnEGQsxBFL	rumor
Charlie Hebdo We ignored the threat from within our own societies , says @Nigel Farage http t co bYPrEBoP15 http t co mLSh5vdJ5Y	non-rumor
Being Black in this country is dangerous business #Ferguson	non-rumor
#CharlieHebdo If we talk about war , we fall into the trap set by murderers , @robinlustig http t co dbBJUkm0sR http t co IqouaAdFxx	non-rumor
How the #CharlieHebdo terrorist attack unfolded http t co yxqCbTWoon http t co t2ryyDt2R2	non-rumor
The #Ferguson police chief just basically confirmed #MikeBrown was gunned to death for the crime of walking in the street \? Horrific 	rumor
DEVELOPING story here Gunman killed in Ottawa 3 shootings confirmed http t co AmIGGlYu4l	rumor
Such powerful images of hostages escaping , those poor women And the fear for those still trapped inside #Sydneysiege http t co TeEnRk6JTi	rumor
Pilots of crashed Germanwings flight declared emergency at 10 47 a m as plane fell rapidly http t co 9YonrFRes3	rumor
