TV pictures show two more people emerging from Sydney Lindt caf they appear to be staff members #sydneysiege http t co bIXelwv03X	rumor
I wish that all news outlets publish #CharlieHebdo 's cartoons satire tomorrow on their front pages as a tribute to the dead RIP	non-rumor
France is at its highest possible terror threat level after the #CharlieHebdo attack http t co 1z7NtGWe5i http t co kopINQNwfj	non-rumor
Demonstrations of solidarity after Charlie Hebdo attacks in pictures http t co EgRSRRftBT http t co BqR2JmSxw9	non-rumor
Charlie Hebdo to Print 1 Million Copies in Defiance After Attack http t co 2kvfnSm5oI via @business	non-rumor
 @OttawaPolice Incidents occurred at National War Memorial , near the Rideau Centre and Parliament Hill Live blog http t co q98AMohu7T	rumor
A loud bang was reportedly heard moments before a group of hostages fled the cafe http t co IxPuyIrNy2 #sydneysiege http t co PjH3lFYdNW	rumor
Three people spotted running out of #Lindt cafe , shielded by heavily armed police #sydneysiege #martinplacesiege http t co DCezDxucaj	rumor
#Sydneysiege what we know http t co rhQ4TLeqHE http t co t0RBx9kS69	rumor
Stop hijacking our faith you crazed murderers ! Thoughts and prayers with victims amp their families #Charliehebdo	non-rumor
Single finger raised by #CharlieHebdo gunman looks like what ISIS fighters often do in battle http t co 6GmumrBndC CC @EliotHiggins	non-rumor
#UPDATE Three men including two brothers identified in France newspaper attack source http t co 5NoNuqJSu1 #JeSuisCharlie #CharlieHebdo	rumor
Smoke is emerging from building at site of hostage situation Gunshots , loud blasts heard http t co IZoucAQgFi #CharlieHebdo	non-rumor
4 cartoonists who died in the attack on #CharlieHebdo AFP http t co UmyMvBKAa8	non-rumor
BREAKING French police Suspects in newspaper attack appear to have taken a hostage northeast of Paris	rumor
Again , when a cartoon is worth 1000 words By Robert Mankoff The @NewYorker Sept 2012 #CharlieHebdo \( @BobMankoff \) http t co HcY9M1A9QH	non-rumor
Ottawa shooting suspect named as Michael Zehaf Bibeau 2 U S sources tell ABC News 	rumor
Sydney Siege Up To 40 Hostages Held Reports #sidneysiege @skynews http t co 6NcYLpqsIN	rumor
They released that information this morning about the robbery KNOWING #MikeBrown was n't stopped for it \? Explain why EXPLAIN WHY #Ferguson	rumor
Now hearing 148 passengers crew on board the #A320 that has crashed in southern French Alps #GermanWings flight @BBCWorld	rumor
Support #CharlieHebdo and show Islamists we wont be scared Pls retweet the most offensive #CharlieHebdo cartoons ! ! http t co YtOm1GO99y	non-rumor
BREAKING Co pilot was Muslim convert http t co owHYZXnVN9	rumor
#SydneySiege hostage runs towards police after escaping from cafe http t co TBSBYzD1xd http t co D4qHwljHKt	rumor
'Journalism is printing what someone else does not want printed everything else is public relations' Orwell #JeSuisCharlie	non-rumor
If you want to follow the hostage situation in Sydney http t co wPRiPQpSBX	rumor
OFFICIAL Police launch assault where #CharlieHebdo suspects holed up \( AFP \) http t co yvvkRFLiMl http t co 2xVhMWliRS	non-rumor
If you tweeted #JeSuisCharlie , now we need you to tweet #JeSuisJuif	non-rumor
#JeSuisCharlie Cartoonists pay tribute to #CharlieHebdo victims http t co RkYfIcAlID http t co hiWvfDm6FM	non-rumor
UPDATED Soldier dead , 2 others injured in Parliament Hill siege 1 gunman dead http t co cVCQKEDlPo http t co zUJUAATG5I	rumor
JUST IN A separate shooting and hostage situation at a supermarket in eastern Paris has been reported developing	rumor
BREAKING UPDATE The latest footage from Sydney siege shows a man holding a female hostage as a human shield #9News http t co pJ5gsqgjQL	rumor
If you are in Sydney , err on side of safety Also be very cautious in case Lindt cafe is a diversion for something else 	rumor
Absurdly , I'm told this is not time to talk about reforming Muslim attitudes to blasphemy Seriously What planet are we on \? #CharlieHebdo	non-rumor
How cartoonists around the world responded to the Charlie Hebdo attack http t co alxmVb4EU0 http t co 9KXhtkFNZW	non-rumor
RT @dabeard Wow @newyorker cover #charliehebdo http t co XKCQbCeHPz	non-rumor
#US consulate reportedly evacuated amid #Sydneysiege hostage situation http t co 1ZlzKDjvSf #martinplace http t co usVgXibdKO	rumor
A quick infographic explaining some of the immediate anti Muslim backlash in France http t co Wuh9TW9IxA #CharlieHebdo	non-rumor
Interesting that #MouradHamydInnocent is trending , started by classmates who say suspect Mourad was in class at time of #CharlieHebdo attack	rumor
Photos from scene of deadly attack by gunmen at Paris offices of newspaper Charlie Hebdo http t co E1zzO50LxX http t co zzzDoDHCSi	non-rumor
The staff of Agence France Presse stand in silence amp solidarity to remember their murdered colleagues #JeSuisCharlie http t co jgQOVlPOKV	non-rumor
UPDATE Police officer shot outside Paris this morning dies http t co OoALEHIyC4 #Montrouge http t co OgAwuVq0rM	rumor
#CharlieHebdo massacre 'Attack will heighten anti Islamic tensions across Europe' http t co 1EBlSuVTWe	non-rumor
URGENT Both #CharlieHebdo suspects killed reports http t co QZbkbOTJNg http t co PB05L1pWmZ	rumor
9 11 attacks , London 7 7 bombings , Madrid , Boston Marathon , Fort Hood , Paris , Oklahoma Beheading but we 're not supposed 2 question Islam \? 	non-rumor
RT @socdec #Charb , cartoonist killed in #ParisShooting , after death threats http t co AKQHq6bqGf #CharlieHebdo #JeSuisCharlie	non-rumor
Too many news organisations now showing online footage of killings at #CharlieHebdo office but not the cartoons for which they were murdered	non-rumor
Ottawa shooting Kevin Vickers labelled 'hero' after taking down gunman in Canadian Parliament http t co z3r8w1DIr1 http t co 68ckieXIsf	rumor
More freedom satire from Charlie Hebdo The Pope in Paris The French Are As Idiotic As The Blacks http t co LpQG9TmIlM ht @LeJebly	non-rumor
BREAKING Soldier shot at Canadian parliament , authorities say http t co Dg2QJtPZ6B http t co cslSESe9V2	rumor
MT @KLynnTrice #Ferguson #FergusonShooting #MikeBrown http t co ucqMi2JLxd Best tweet of the day for me 	non-rumor
#CharlieHebdo last cover satirizing #ISIS If Mohammed returned But I'm the Prophet , blockhead ! Shut up , infidel ! http t co ausIfclXrF	non-rumor
Love #ferguson https t co CKUpWXYjkC	non-rumor
According to reports , one gunman is dead in #Ottawa Parliament shooting LIVE coverage http t co NZrpLq5Coo http t co f6PV2xgRBh	rumor
Hostages being held in a Sydney cafe Islamic flag seen in window , local news reports http t co qMagxP5wuc	rumor
#JeSuisCharlie a brilliant image by @iGaddo Let 's all stick our pencils up in defiance http t co wm5jNdaP8x	non-rumor
A brief history of Charlie Hebdo , the satirical magazine at the centre of today 's terror attack in Paris http t co mewhhD9cOm #paris	non-rumor
Praying for the hostages in #Sydney For speedy rescue and no one harmed #sydneysiege	rumor
Charlie Hebdo Fox news anchor suggests skin colour helps identify 'typical bad guys' http t co XvkeSMMXC4 http t co zcQjFbUY6P	non-rumor
The entire world is rallying The terrorists plan has backfired #JeSuisCharlie #CharlieHedbo http t co exzKIGsdag	non-rumor
Update AFP reports #CharlieHebdo will publish an edition of the magazine as normal next week	non-rumor
So police narrative in #Ferguson is unarmed teen suspected in unarmed robbery was shot to death We 've still got a problem , Chief 	rumor
6 days after Charlie Hebdo 's 2011 firebombing , it ran an image of a cartoonist kissing a jihadi , with caption Love is stronger than hate	non-rumor
BREAKING Four explosions heard at site of hostage taking in eastern Paris Reuters reporter http t co 91WTMcaRDz	non-rumor
Egypt top Muslim institution Al Azhar and the Arab league condemn Paris #CharlieHebdo attack @akhbar	non-rumor
Here are some of the satirical pictures Charlie Hebdo have produced #freespeech #BanIslam http t co m4OaNCf5e0	non-rumor
Paris says highest alert level extended north to region where attack suspects spotted @AFP , @MelissaBellF24 https t co pj8kecnVt7	rumor
 Some read the Quran and blow up girls schools , but more read the Quran and build girls schools @NickKristof http t co oVKdSiczOh	non-rumor
#OTTAWA SHOOTING Police claim multiple suspects at large , ask people to avoid Paraliment area http t co Zp9AKplH9p http t co b3yQV4ewOs	rumor
48 hrs , amp Paris makes #CharlieHebdo honorary citizen 20 mths amp our craven elites won t even name a Lee Rigby memoral for fear of offence 	non-rumor
THE TERRORIST ATTACK IN PARIS IS SO SCARY I'M CRYING	non-rumor
Thoughts and Prayers with everyone in Ottawa \( our office is here in Capital \) right now on Parliament Hill with shots fired #PrayForOttawa	rumor
 Muslims do n't believe in freedom of speech radical cleric Chaudry http t co or8tYpGCiH #CharlieHebdo http t co W2HAAKOJjQ	non-rumor
Kevin Vickers hailed as hero who took down attacker at Parliament Hill http t co sG70iQtfSM #cbcOTT #OTTnews http t co zuSOkiOzck	rumor
Keep #dontshoot going ! That 's the chant of our young people in #Ferguson ! http t co CBFBGd63TM	non-rumor
LIVE video from scene of deadly attack on Paris offices of satirical weekly Charlie Hebdo http t co h3uQuxHeTF http t co MzzOMR19ve	non-rumor
Martin Place , Sydney Opera House amp State Library evacuated due to #sydneysiege follow our blog http t co 4MUc9ivwbK http t co s6hCQ8QOAs	rumor
Hackers Supporting ISIS Hacking French Websites and Putting Up Anti Charlie Hebdo Messages http t co WagR2B9OjF http t co bz5r0DJkme	non-rumor
Lindt Australia CEO says probably about 10 staff , 30 customers in Sydney cafe at time of siege @SkyBusiness #sydneysiege \( @liztilley84 \) 	rumor
More shots being fired near parliament in Ottawa , suspect still at large TV	rumor
BREAKING NEWS Ottawa police now confirm one suspect has been killed 2 suspects remain at large 	rumor
To all my Muslim friends you do n't need to apologize for the #CharlieHebdo attack in Paris A criminal committed a crime , not Islam 	non-rumor
This is why I do n't give a Shit How Terrorist R interrogated @benshapiro @HeyTammyBruce @MonicaCrowley #CharlieHebdo http t co EEFH0zg7Qa	non-rumor
Horrific attack on France and free speech France , the cradle of press freedom Deep condolences and solidarity #CharlieHebdo	non-rumor
BREAKING French authorities say the two #CharlieHebdo terrorists are still armed and extremely dangerous 	rumor
Does somebody want to tell me how ISIS is n't Islam again , after murdering 12 in #France over a cartoon over muhammed \? http t co rmgzDNrJVO	non-rumor
I m in #Ferguson and the witnesses are telling a chillin story This young man was truly executed 	non-rumor
Vision now confirms #sydneysiege perpetrator is using young woman as a shield as he paces around in view of windows amp police outside 	rumor
French President Hollande says that he expects there to be no survivors in the Germanwings plane crash 148 passengers reportedly onboard 	rumor
The police presence in #Ferguson following the shooting of Michael Brown was mind blowing http t co UGdNcWtpbH	non-rumor
Breaking Sources tell @praveenswami #CharlieHebdo attack ws petty robbery ! Cong demands French Govt give proof attackers are terrorists	non-rumor
Islamists are holding people hostage in a cafe in Sydney , Australia Meanwhile , we wet our pants over pouring water on a terrorist s face 	rumor
CRISIS IN FRANCE Massacre suspects take hostage at business near Paris Policewoman killer takes hostages at supermarket in east Paris	rumor
UPDATE 12 now confirmed dead in #CharlieHebdo attack in Paris , @AP is reporting Story http t co Jfqmha1GdV \( AP \) http t co vDCIFHIa9U	rumor
The presence of police dogs in #Ferguson is , at the very least , culturally and historically insensitive 	non-rumor
Police convoy and helicopters are rushing to scene to detain Charlie Hebdo massacre suspects http t co XdUgohNDhv http t co MSROYqs14o	rumor
Fuck Islam and fuck their pedophile prophet That 's all #CharlieHebdo http t co LlVvy35DUg	non-rumor
Trocadero , it was a fasle alert \( Ministry of Interior \) Via @WilliamMolinie	rumor
Police say there are 3 shooting scenes Parliament , War Memorial , Rideau Centre They happened close together , police say #cbcOTT #OTTnews	rumor
Photo of man that is holding hostages in the second location in #Paris http t co nc0lFlm93c	non-rumor
#CharlieHebdo shooting suspects tell police they 'prepared to die as martyrs' French media http t co G6eunBDIrj http t co jOnfaapehF	rumor
If you tweeted #JeSuisCharlie but wo n't tweet #JeSuisJuif today , I think we can all figure out the reason http t co eVtOYbvlrP	non-rumor
Charlie Hebdo , the magazine that dared to poke fun at religion http t co L5wXIOOr2p http t co SpDK2rMW4K	non-rumor
Top French cartoonists Charb , Cabu , Wolinski , Tignous confirmed among dead in #Paris #CharlieHebdo attack Editor is critically wounded 	rumor
#MikeBrown wanted to walk down the street And he is dead And the #Ferguson PD is using his silence in death to make him a criminal 	rumor
There should be blame AND shame here #Ferguson #MichaelBrown @KharyP http t co hXWpgy4nRY	non-rumor
Armed with kalachnikovs amp rocketlauncher , 2 men open fire at French satirical mag Charlie Hebdo that published Prophet Mohamed cartoons @AFP	rumor
Canadian Prime Minister Stephen Harper is due to make a statement shortly , reports say http t co dUvWlCCpdY #OttawaShootings	rumor
The #CharlieHebdo magazine covers the Islamic terrorists did n't want you to see http t co AUkRckrdOJ http t co bpmGf56tAa	non-rumor
NATO calls Russia anti terror ally after Paris attack http t co md6EqMVZ0u #CharlieHebdo http t co VzHQYxNmXw	non-rumor
#WeAreTargets People marching to the #Ferguson Police Dept headquarters following the killing of a 17 year old boy http t co wFTR1maej7 	non-rumor
#BREAKING Schools near Paris hostage taking go into lockdown officials	non-rumor
Terrorist attack in Paris at satirical magazine is just heartbreaking Prayers So is the #NAACPBombing I wish we would talk about both 	non-rumor
#Ferguson Regardless of what color you are the militarized police response here is BONECHILLING http t co uumztSc6c8	non-rumor
Please join me in prayer for those held hostage in Martin Place , Sydney , and for the police who are trying to resolve the situation 	rumor
If u r white amp u r not outraged about #Ferguson then the problem is much bigger than the police #americaforall	non-rumor
Civilians being evacuated , schools in lock down as new hostage situation unfolds in Paris http t co cI8cztQjE6 http t co 5z4omAvypP	non-rumor
Islamist militants take hostages in Sydney caf , display black jihadist flag http t co Audo3xS9w3 #sydneysiege http t co mDWczVjCNc	rumor
There is never justification for violence because one is offended by a cartoon Ever #CharlieHebdo http t co RhBpC5Iwh9	non-rumor
Hostages in Sydney cafe made to hold up Islamic flags http t co I1PsUPekkB	rumor
Update French television channel 'France 2' are reporting that the hostage held by suspected #CharlieHebdo gunmen is male and 26 years old	rumor
We condemn the attack on #CharlieHebdo Whomever the attackers are , and whatever the cause may be , nothing justifies the taking of life	non-rumor
CANADIAN OFFICIALS NOW CALLING TODAY'S PARLIAMENT SHOOTING A TERRORIST ATTACK http t co 5VYMWGWyx3 http t co jQn39E7hTA	rumor
#Ottawa police confirm fatal shooting of Canadian soldier at War Memorial , and shooting death of gunman in Parliament No one in custody 	rumor
 I do not agree with what you have to say , but I 'll defend to the death your right to say it Voltaire #JeSuisCharlie	non-rumor
RT @WatchCTVNews LIVE NOW Cops swarm Parliament Hill following reports of a shooting http t co ekj0wMrYdV http t co 55Iz2M0542	rumor
#CharlieHebdo will continue publishing in wake of the attack http t co djW9x4BqHQ http t co xDlLZ4AtPe	non-rumor
The occasional police car drives through and some shouts of F ck the Police ! can be heard But back to peaceful when they leave #Ferguson	non-rumor
Global News camera man reporting shots fired by Chateau Laurier hotel #ottawa	rumor
Suspected #CharlieHebdo killers are in same jihadist group as hostage taker in Paris store , police union rep says http t co 7Bxdhozq4H	rumor
You shouted 'Allahu Akber' whilst murdering others \? You are a disgrace to my religion May the dead rest in peace #notinmyname #charliehebdo	non-rumor
NHL says date of rescheduled game TBD NHL ``wishes to express its sympathy and prayers to all affected by the tragic events in Ottawa''	rumor
BREAKING Two brothers suspected of #CharlieHebdo terror attacks in Paris killed , according to reports in France http t co 23JyHdGnp7	rumor
Central Sydney shut down by police amid ongoing hostage situation http t co TvAlMmqFxP	rumor
Children being let out of school lockdown near Paris , as police hunt #CharlieHebdo suspects http t co 7Bxdhozq4H http t co 8UdTgzIVft	non-rumor
Federal grants drive cop militarization in '12 St Louis County got Bearcat armored vehicle , other goodies http t co uZymzagDmU #ferguson	non-rumor
The world would be a far better place if all religious fanatics followed this advice #CharlieHebdo http t co HD43ebNTbT	non-rumor
Paris attack suspects have taken a hostage French police have them cornered near Paris airport Live http t co fw92nASZxK	rumor
This is trending on French twitter #MouradHamydInnocent started by classmates who say Mourad was in class when #CharlieHebdo attack happened	rumor
Paris terror attacks six explosions heard at kosher supermarket in Paris live updates http t co mtPv1mMS0D	non-rumor
BREAKING Two Charlie Hebdo attack suspects in Dammartin en Goele killed by security forces govt source http t co oZmSoaIueK	non-rumor
Breaking Paris police say 12 dead after shooting at Charlie Hebdo http t co kugeXjzDlf	rumor
 I know his initial contact was not related to the robbery , #Ferguson chief says It was related to blocking the road 	rumor
We should never be ashamed to be Muslim but we should publicly condemn the savages who tarnish our name ##ParisShooting #CharlieHebdo	non-rumor
ISIS FLAG VISIBLE AS GUNMAN SEIZES SYDNEY CAFE , HOLDS HOSTAGES	rumor
BREAKING #CharlieHebdo terror suspects killed in police raid , hostage freed , @AFP reports http t co Ema5cTI48c	non-rumor
Another account of what happened to #MikeBrown #JusticeForMikeBrown http t co sOD2olFYwp #STL #FERGUSON	rumor
Why Muslims should embrace free speech , even if it includes insults to their Prophet http t co S12EYrY2Qs #CharlieHebdo	non-rumor
Steve Bell 's cartoon on the Charlie Hebdo attack http t co AdVfwBB5AP http t co 5jPLPdRI8a	non-rumor
If your religion is worth killing for , please start with yourself #CharlieHebdo #ParisShooting #ParisAttack	non-rumor
I may not agree with what you draw but I will defend your right to draw it That , my friends , is the whole point #CharlieHebdo	non-rumor
I'm so saddened by the tragic events at Charlie Hebdo and my heart goes out to their families , friends and community in France 	non-rumor
So now let 's talk seriously about #CharlieHebdo and Western double standard on freedom of speech #JenesuisPAScharlie http t co XzsJQF12Uv	non-rumor
#CharlieHebdo Uncensored video of Shooting http t co 6m6DuFb8i3 #cabu Bernard Maris #Wolinski #attentat #Tignous #fusillade	non-rumor
We are hearing a shooter is still on the loose here in DT Ottawa with a rifle please pray for our police and soldiers #PrayForOttawa	rumor
I do n't want another bigot getting in my TL saying it 's not abt race , when 's the last time a white kid has been MURDERED by police #Ferguson	non-rumor
Hostages inside the siege have told Australia 's @channelten that the gunman , calling himself The Brother , has two bombs inside 	rumor
When police are militarized , they go to war with citizens #Ferguson http t co WHMDzIegv1	non-rumor
Jews , Catholics , Muslims , white people , black people Everyone attacked by Charlie Hebdo , yet who reacts like this \? http t co fkvhfJxPoO	non-rumor
Scene at Ottawa war memorial Soldier on duty shot http t co QvXGDUM4NC	rumor
There 's cameras on every corner of the hood Let 's out cameras on every cop What do you have to hide \? #Ferguson http t co 76T6HmnsnS	non-rumor
A sad day for France , for journalism , for free speech , and those whose beliefs the attackers pretend to represent #CharlieHebdo	non-rumor
WATCH Shots are fired inside Ottawa 's Parliament building Canadian police say shooting suspect is still at large https t co mzxG4e8m84	rumor
Police Surround Sydney Cafe , Where Armed Person Holds Hostages http t co CPrsOcTuis	rumor
The black amp unarmed group on the left is called an angry mob vs the armed white group called supporters #Ferguson http t co EuEvQHHEpK	non-rumor
The whistleblower , a white man who went by the name of Lonewolf , said Black people should be allowed to shop w o harassment #Ferguson	non-rumor
Follow this list for journalists amp media outlets covering #CharlieHebdo attack aftermath http t co AIL3k1MWnO http t co 9yg7GQIASz	non-rumor
#CharlieHebdo attack is a barbaric act of terrorism Nothing can justify it Muslim scholar Gulen must be remembered http t co NgQNmlPqBf	non-rumor
BREAKING Police have confirmed 3 people escape Sydney cafe where hostages are being held	rumor
The #GermanWings plane is believed to have crashed shortly after a distress call reporting an abnormal situation http t co mLLtayvg1M	rumor
#PrayForOttawa As an American Veteran , my prayers are w the Canadian soldier who died in today 's shooting standing duty at a war memorial 	rumor
The sights and sounds from #Ferguson , Missouri are unbelievable http t co D0n0QYN8x2 http t co A3obQOvf4o	non-rumor
The #CharlieHebdo attack suspects have reportedly fired shots while robbing a petrol station http t co joSfDCybpI http t co 7xQIrb4vbU	rumor
We are Charlie Hebdo in the same sense that we demanded Boko Haram bring back our girls You know , the girls we no longer talk about 	non-rumor
Police stand guard as hostages are held in a cafe in Sydney Follow AFP 's LIVE REPORT http t co yKWnSmShSY http t co wyjunPbDfo	rumor
Sally Kohn compares today 's #CharlieHebdo attack to all the 'Christians or Jews killing in name of religion' http t co v3ScYGoWOX	non-rumor
LIVE Police close in on Charlie Hebdo suspects hostages taken in eastern Paris http t co F6LMSCjCT4 http t co WCjr5CthJZ	non-rumor
DGAC clarifies Germanwings did n't itself issue distress call but ATC launhed distress phase due combination of descent and no radio contact	rumor
Shooting at Paris office of #CharlieHebdo magazine ranks as one of the deadliest attacks on Paris in 20 years http t co hyX5zWvaK2	non-rumor
Currently the #FoxNews website has zero , repeat , ZERO coverage of the #Ferguson protests , probably due to lack of cowboy hats 	rumor
#RespectForMuslims Western #media will never highlight these #Muslims Plz RT #CharlieHebdo #France #Paris http t co uuFZFawDW4	non-rumor
Just confirmed 10 people dead at shooting in the centre of #Paris Many believed to be journos working for #CharlieHebdo	rumor
The Robbery Incident Report released by #Ferguson PD today is sketchy at best What stood out \? NAMING #MikeBrown How did they know \? 	rumor
Three people seen running out of Sydney cafe where hostages have been held for hours live updates http t co vywOk7zMoS #sydneysiege	rumor
Brilliant piece by @OwenJones84 on how the Paris shootings must not lead to more Islamophobia http t co aPNqc9qTHI	non-rumor
Germanwings crash plane 'lost signal at 6 , 800 feet' , flight radar shows http t co AjQxaENYSb http t co cgU1GqKYqK	rumor
Map shows where gun attack on satirical magazine #CharlieHebdo took place in central Paris http t co 5AZAKumpNd http t co ECFYztMVk9	non-rumor
Notice it 's involved in the shooting not killed a child Notice it 's paid administrative leave not has been arrested #Ferguson	non-rumor
Horrible tragedy in Paris today was not done by Muslims , but done by terrorists Let us unite against hate pray for peace #CharlieHebdo	non-rumor
BREAKING Soldier shot near Canada 's parliament active shooter at large http t co ldO9r3y0JQ http t co 5Ssy2fEmSb	rumor
Gunshots heard , smoke seen at site of police operation in Dammartin en Goele , northeast of Paris @Reuters , @SkyNews http t co ZFJYh80uxy	non-rumor
#JeSuisCharlie Charb who was assassinated today The Kurds defend us all Rest in peace brother #TwitterKurds http t co L5yVsCOedk	non-rumor
Every 28 hours a black male is killed in the United States by police or vigilantes #Ferguson	rumor
An eyewitness video shows a gunman shooting a police officer and driving away http t co LILudVXzlV #CharlieHebdo http t co HBYEWZscqn	non-rumor
Real Muslims have never seen , and cannot see #terrorism as a way for solving their problems #CharlieHebdo http t co sdJvdNxAGM	non-rumor
Charlie Hebdo 's latest issue They made fun of all religions http t co FdMHriGpzh	non-rumor
BREAKING Astonishing video of the Paris terror attack as it was happening gt http t co sglPyWCWhL \( via @BBCDanielS \) #CharlieHebdo	non-rumor
Such a moving photo from @mariotestino , it actually brought a tear to my eye #JeSuisCharlie http t co s8Zv6gtK96	non-rumor
People in the street shouting No Justice , No Peace and blocking a Kinloch police car from passing #Ferguson http t co 7jp4rqT4G6	non-rumor
AFP reporting at least five hostages have been taken at kosher shop in Paris live http t co hRxscrV6yW #CharlieHebdo	rumor
Lots of people some prayerful , some sad , some angry have gathered outside the #Ferguson police headquarters http t co KfbHCGNrzk	non-rumor
BREAKING Paris prosecutor Gunman with hostages in kosher market in eastern Paris police SWAT on scene 	rumor
Several mosques in France allegedly attacked after the #CharlieHebdo massacre http t co nAXb9CjxPw http t co N04rvxa6B4	non-rumor
Minute silence held in memory of victims of shooting http t co LdSF5QeCiv #CharlieHebdo #JeSuisCharlie http t co dj3hfNsZko	non-rumor
Nearly 7k blacks were murdered last yr almost all by other blacks A tiny were unarmed killed by cop Where 's Al , Jesse \? #tcot #ferguson	rumor
Good backgrounder from The New Yorker from 2012 The Charlie Hebdo Affair Laughing at Blasphemy http t co LDwDceoxFg	non-rumor
Germanwings Airbus A320 crashes in French Alps near Digne http t co yNlWbNJmYI	rumor
This HAS to stop #CharlieHebdo http t co lPrNCPNB5E	non-rumor
Official All 3 patients injured in Ottawa shootings have been released from hospital @OttawaHospital http t co aF9HyT9BgX	rumor
Please Retweet to show your support for #FreedomOfSpeech ! #ParisShooting #RedNationRising #RIP #CharlieHebdo http t co QZw0kjw7C2	non-rumor
#ChalieHebdo terrorists are held up in a warehouse with hostages #JeSuisCharlie http t co AJYsqfKMwa	rumor
Someone with better eyes than me please #checkthedatestamp on the bottom left photo Is n't that JUNE \? #Ferguson http t co PTNuxY2v5B	rumor
Supposedly there might be one or two witnesses who have the shooting or part of the shooting recorded on their phones #Ferguson	rumor
3 people have come running out of the Lindt cafe building , including a man who looked like a cafe worker #MartinPlaceSiege #sydneysiege	rumor
German Wings airline tweeting now about reports of plane crashing in French Alps with 148 on board @germanwings http t co SqUrmcvNKt	rumor
Here 's a vine showing the dramatic moment three hostages escaped the #sydneysiege https t co 7VWb7IW5hm	rumor
2 brothers suspected in #CharlieHebdo attack killed by police after standoff NE of #Paris Kosher market hostage taking reportedly over too 	non-rumor
French Interior Minister says operation under way to detain 2 #CharlieHebdo suspects http t co 2pHnT9UofV	rumor
UPDATE 13 hostages inside Sydney coffee shop near Sydney Opera House Abbott will deliver a statement shortly #ISISAttacks #sydneyseige	rumor
Even before #Charlie Hebdo killings , in many places journalism had become a life threatening proposition http t co Fig0E5Vmkn	non-rumor
Banksy account joins cartoonists support for #CharlieHebdo #JeSuisCharlie http t co nFD1N4Yqu0 http t co R2bEWKupRt	rumor
I am still confused as to why these highly trained individuals left their ID in the getaway car #CharlieHebdo	rumor
Freedom of speech is a right as much as a cause worth fighting for Obscurantism is a danger made real today #CharlieHebdo	non-rumor
 Happening Now Shooting and hostage situation at Kosher supermarket in eastern #Paris http t co TszoK14DJH http t co lAYTn6mfvs	rumor
#BREAKING HOSTAGES TAKEN AT A BUSINESS IN DAMMARTIN EN GOELE RTL REPORTS #France http t co aa3FJVho8K	rumor
#BREAKING @kenneyjason confirms the soldier shot this morning has died , a Parliamentary Guard has also been wounded #OttawaShooting	rumor
BREAKING NEWS CBC confirms photo of Michael Zehaf Bibeau , the gunman in the Ottawa shooting http t co 58IK7FMcA1 http t co HmCjJGCn0F	rumor
#CharlieHebdo an equal opportunity satirical mag in the grand tradition of #France Long may that tradition continue ! #FreedomOfSpeech	non-rumor
I'm no fan of #charliehebdo but this is a sickening , terrifying , unjustifiable attack on journalists My thoughts amp prayers with the victims	non-rumor
BREAKING Police order all shops closed in famed Jewish neighborhood in central Paris far from attacks 	rumor
Chambers and W Florissant right now #Ferguson http t co fLag6Sw0MU	non-rumor
Please note Twitter had the #Ferguson story BEFORE ALL national news outlets But keep telling me how Twitter does n't matter 	non-rumor
Pres Obama condemns the #CharlieHebdo attack Paris will endure well beyond the hateful vision of these killers http t co Gn69hWYyg2	non-rumor
Remember when Charlie Hebdo satirised Christianity , Judaism amp Catholicism amp people were killed because of it \? Exactly There 's your problem 	non-rumor
Video of #terrorists attacking Charlie Hebdo HQ in Paris http t co SdniwkJtT1 http t co z6O8IhNjCk	non-rumor
Police confirm that live ammunition was used as heavily armed police stormed the caf in Sydney @9NewsSyd http t co N5mmnilz4Z	rumor
Very tense situation in Ottawa this morning Multiple gun shots fired outside of our caucus room I am safe and in lockdown Unbelievable 	rumor
Escaped #SydneySiege hostage , Elly Chen , a top student and skilled sportswoman http t co cOyz8N2IMb http t co 48YdSm7lJB	rumor
The hypocrisy in the western world \( Political cartoon from Carlos Latuff \) #CharlieHebdo http t co EkMKJTfIyk	non-rumor
RIP Corporal Nathan Cirillo Thank you for serving our country Gone but never forgotten #OttawaShooting http t co 51dY4VTp2K	rumor
If Michael Brown had been white , @stltoday would have described crowd not as a mob , but as a 'heartbroken community' #Ferguson	non-rumor
#CharlieHebdo famous cartoonists Charb and Cabu shot dead according to reports http t co 4wugwxfVjj http t co SblgDDXGiD	rumor
The City of Hamilton offers condolences to the family of Cpl Nathan Cirillo , a #HamOnt native who bravely served with @TheArgylls #Ottawa	rumor
Religion of peace back at work Muslims attack French magazine that mocked Muhammad , killing 12 #CharlieHebdo #ParisShooting	non-rumor
Cartoonists are often our dearest allies in fight 4 freedom of expression , and freedom in general We mourn our #CharlieHebdo colleagues 	non-rumor
#JeSuisCharlie rallies held worldwide to condemn Paris massacre \( PHOTOS \) http t co EnwxH90grB http t co hzH208lEB2	non-rumor
Police have named the cop who shot Michael Brown @alicesperi 's latest report from #Ferguson http t co 1K79nsOtx3 http t co cV3VCkUR6L	rumor
Our cover #CharlieHebdo #JeSuisCharlie http t co q29opNZ0jr	non-rumor
The instrumentalization of Charlie Hebdo Some defend freedom of speech all the time Others only when they can use it to spy , drone , more 	non-rumor
#4U9525 Robin names Andreas Lubitz as the copilot in the flight deck who crashed the aircraft 	rumor
what 's happening at the moment is really bad ! I respect every religion ! but this is just terror ! ! ! #StopViolence #JeSuisCharlie	non-rumor
Heart goes out to 148 passengers and crew of Germanwings Airbus A320 that has crashed in French Alps , Southern France http t co K7fmJLRt4G	rumor
Charlie Hebdo editor St phane Charbonnier said he 'd rather die standing than live on my knees http t co 01AbH3nCQc	non-rumor
Editorial cartoonist @AnnTelnaes on the Charlie Hebdo attack http t co 8F10iZJdIE http t co NvmXqT6U3t	non-rumor
Grand Mufti of Australia statement condemning #SydneySiege http t co 8juQ032EdP	rumor
BREAKING Germanwings crew did not send distress signal aviation official @AFP	rumor
At least two killed in hostage drama east of Paris Photo @MartinBureau1 #AFP http t co ZvcbbTgvNm	rumor
#Germanwings sorry to confirm 144 passengers amp 6 crew on board flight #4U9525 when it crashed in French Alps http t co inQlKOqZup	rumor
#Banksy 's take on #CharlieHebdo #JeSuisCharlie #NousSommesCharlie http t co f6Y07d9fJ1	rumor
Charlie Hebdo s editor When activists need a pretext to justify their violence , they always find it #CharlieHebdo	non-rumor
Free speech must not be silenced in the wake of Charlie Hebdo attack http t co PcnpZcD9iM	non-rumor
Salman Rushdie Satire has always been a force for liberty and against tyranny , dishonesty and stupidity #CharlieHebdo	non-rumor
Social media users show solidarity for #CharlieHebdo with #JeSuisCharlie hashtag http t co v0m1buPOMy http t co mci5nwDlDQ	non-rumor
Prediction the survivors of Charlie Hebdo put out a new issue , the cover of which big Western media will find too offensive to reprint 	non-rumor
According to AFP a number of hostages have been freed after police raided supermarket Hostage in #Dammartin free http t co LdSF5QeCiv	rumor
Ottawa shootings reportedly at three locations parliament , war memorial and shopping mall http t co fULkb6VpEv http t co mL9Ivehy6Q	rumor
AFP an official says a Canadian soldier has died after being shot in #OttawaShooting	rumor
COUNTDOWN One hour until #Ferguson police release the name of the officer that shot #MichaelBrown 	rumor
People died today for telling jokes #CharlieHebdo	non-rumor
Asked why he released surveillance video of robbery , Chief Jackson responds , because the press asked for it #MikeBrown #Ferguson	rumor
BREAKING A #Lufthansa #Germanwings Airbus jet carrying 148 people has crashed in southern #France , en route from #Barcelona to #Duesseldorf	rumor
Asterix and Obelix pay tribute to #CharlieHebdo victims \( via @asterixofficiel \) http t co ssgYsoKoIC	non-rumor
#CharlieHebdo published a cartoon of the notorious #ISIS leader last week \( They 've just tweeted the pic again \) http t co YYyxzNaFFb	non-rumor
World sends messages of condolence , outrage , defiance via #JeSuisCharlie after Paris attack http t co deqrOSVi0m http t co Ama2pSOvZN	non-rumor
#JeSuisCharlie vigils held around the world in pictures http t co JlcL5LdY69 \( Pic E CASTRO MENDIVIL REUTERS \) http t co WY0KSMSWS6	non-rumor
Why it 's Charlie Hebdo 's right to draw Muhammad http t co GlF9dgwFS0 http t co YRxTwsNu5q	non-rumor
Rest in peace Cpl Nathan Cirillo via @globeandmail #ottawashooting http t co voEK2MZpfR http t co sMpeSGv4HY	rumor
#BREAKING Germanwings says 144 passengers and 6 crew on crashed plane	rumor
#BREAKING Soldier shot at the National War Memorial has died , CTV has confirmed	rumor
To all white ppl horrified by #Ferguson go to police , school board , amp mayor and teach how anti blackness kills They do n't listen to us 	non-rumor
People are angry , frustrated but peaceful tonight in #Ferguson The police dept 's heavy handed approach made things worse Leaving was good 	non-rumor
so they clearly released that video only to shame amp blame the victim #Ferguson #MikeBrown	rumor
#CharlieHebdo Attack UPDATE Cartoonists Cabu , Charb , Wolinski die report http t co 3Jsosc7yl3 http t co 3H1ZbykE0D	rumor
JUST IN Germanwings plane crashes in southern France , up to 150 feared dead http t co GIZjXnqBU3	rumor
Feared at least 5 hostages are being held in Paris 'kosher' grocery http t co zoafNwyEtr http t co ntDatZ8Pp7	rumor
Tensions high French police stop scooter near scene of kosher grocery http t co ezfzdBjrbb http t co MXJqNSM1Jm	non-rumor
MORE Airbus A320 that crashed in southern France operated by Germanwings , carrying 142 passengers , 2 pilots , 4 crew http t co XwKPmofTD9	rumor
'One million copies' of #CharlieHebdo to be published as French media vow to keep it running http t co dr8bWwaxlp http t co oIeK0NDhpl	non-rumor
Seeing reports that soldier shot at War Memorial is still alive Hang in there , brother All of Canada is with you 	rumor
This is the scene of the #Sydneysiege at the Lindt Chocolate Cafe in #MartinPlace Live blog http t co AG0jQb072Q http t co kLzdEKnILC	rumor
Nice work from Banksy #JeSuisCharlie http t co w9pJIrf7cP	rumor
Germanwings passenger plane crashes in France http t co BSJhGgMChG	rumor
BREAKING Hostages held in downtown Sydney cafe Islamic flag displayed http t co 1L9s58F6mY	rumor
17 journalists massacres by Israel in Gaza , 2014 Where were these freedom of speech people then \? #CharlieHebdo http t co 6It3pU5EUW	non-rumor
BREAKING ALERT Preliminary reports indicate perpetrators appear to be members of #ISIS #SydneySiege	rumor
Flight #4U9525 initially climbed to 38 , 000 feet before before it started to descend and lost signal at 6 , 800 feet http t co MthXQ232Hn	rumor
BREAKING Five have now escaped a hostage situation at a cafe in downtown Sydney #sydneysiege http t co gl30dy8PYN http t co 7oYbXnAeKV	rumor
The East London Mosque would like to offer its sincere condolences to the families of those killed during the #CharlieHebdo attacks \( 1 2 \) 	non-rumor
BREAKING UPDATE Soldier shot at National War Memorial in Ottawa , Canada , police tell @ABC News http t co wg7WHTjJGI	rumor
The soldier killed in #Ottawa today is being named as 24 year old Nathan Cirillo Latest here http t co Iwpa7Iq2XA http t co nMEOVCJVUa	rumor
Gunmen at #CharlieHebdo 's Paris HQ shouted they had avenged the prophet , reports say http t co 1z7NtGWe5i http t co IEWCMH7oUV	rumor
Ottawa hospital confirms it 's treating 3 #OttawaShooting victims 2 in stable condition http t co IbLAWEjEeD http t co zSoC0VxOKN	rumor
Can confirm that several media outlets know the name and background of the hostage taker Holding off publication #sydneysiege	rumor
This is flag currently held in Sydney window , a garden variety Islamist flag Therefore , doesn t tell us anything yet http t co DgC6wIsE47	rumor
Police say they have located car belonging to suspect in #Ottawa shooting Uniformed soldier shot at War Memorial , condition unknown 	rumor
BREAKING A Sydney cafe at Martin Place is being held up hostages inside have their hands against the windows , ISIS flag visible #7News	rumor
#CharlieHebdo will print 1 million copies next week http t co 9rN03AJrO9 http t co 7W21oQBHTO	non-rumor
GERMAN NEWS REPORT Co Pilot of Germanwings Airbus Was MUSLIM CONVERT Hero of Islamic State http t co JDZ3vZuO2k http t co NqHmAGt6Mf	rumor
#CharlieHebdo witness Gunmen told me to tell the media they were Al Qaeda in Yemen http t co AyDSKynXG2 h t @chawk228	rumor
UnReal Toon #CharlieHebdo 's cartoonists in great demand \( via @sagarcartoonist , with @ajayendar \) http t co KKF0DgCnL4	non-rumor
Map of areas where Ottawa shootings were reported National War Memorial , near the Rideau Centre and Parliament Hill http t co NcfNCR5VCV	rumor
Video shows police surrounding Paris kosher supermarket where gunman reportedly holding hostages http t co Qv1xBajqsX #CharlieHebdo	non-rumor
Attack on #CharlieHebdo The intl community cannot allow extremists to silence the free flow of opinions http t co 1BgO8HRRbf #pressfreedom	non-rumor
The letter from The Independent 's Deputy Editor In solidarity with #CharlieHebdo http t co 9qVffIEjkf http t co i5xPjcJlk0	non-rumor
' but I will to the death defend your right to say it' #charliehebdo #voltaire http t co oFEHT8Xx3v	non-rumor
Telling that some are calling the Charlie Hebdo shootings the worst terrorist attack in Europe since 2005 Breivik doesn t even register 	non-rumor
BREAKING Heavily armed police storm Sydney cafe where gunman has been holding hostages 	rumor
Shooting south of Paris with one police officer injured Police say no known link to #CharlieHebdo attack http t co UZlFI7Bb5s	rumor
This is #Ferguson , a suburb in America http t co GfmHLo4u5q	non-rumor
Everytime a satirist is murdered , 1 , 000 more satirists rise up to take their place #JeSuisCharlie	non-rumor
Update AFP reports at least two people killed after shooting at kosher grocery in eastern #Paris in which at least five were taken hostage	rumor
People should actually know the difference #JeSuisCharlie http t co QIVgReU6Kh	non-rumor
Footage shows three men fleeing #sydneysiege building http t co UxcrhFcL61 http t co boGVVouqKa	rumor
JUST IN #Ferguson Police Chief Thomas Jackson tells @RobinRoberts they will release the name of the police officer today	rumor
A Muslim must always be straightforward and consistent in his actions and words #RespectForMuslims #JeSuisCharlie http t co 9B1fkBYDIG	non-rumor
Convoy of police cars rushing toward town northeast of Paris amid reports of hostages taken @FRANCE24 broadcast http t co ZFJYh80uxy	rumor
Cpl Nathan Cirillo , 24 , identified as the soldier who was shot , killed at the War Memorial today #cbcOTT #OTTnews http t co I68A6Ioa6E	rumor
I am so saddened by the death of a young man serving us and our great nation God bless him #Ottawa #OttawaShooting	rumor
#CharlieHebdo s Charb I would rather die standing up than live on my knees http t co RYrHlAVy7t http t co cxsHfJVlrn ht @froomkin	non-rumor
 I saw a long gun , I heard one shot eye witness to #OttawaShooting at Canadian Parliament http t co 509yRD4iCn http t co YmMtvZDLom	rumor
#Ferguson PD made #MikeBrown the suspect in that robbery police report ON WHAT BASIS DID THEY NAME HIM \? Unless it was written after 	rumor
UPDATE Police storm kosher grocery store in eastern Paris as reports of #CharlieHebdo suspects killed http t co QZbkbOTJNg	non-rumor
Obama supports 'moderate' Muslims #CharlieHebdo #Nosharia #tcot #tgdn #teaparty #PJNET #ccot #RedNationRising http t co 1VUhxsm5S9	non-rumor
UPDATE Reports a gunman is requesting to speak to Australian leaders on live radio , as specialist officers work to make contact #9News	rumor
Uber intros surge pricing in downtown Sydney during hostage siege http t co XWGe9MpUzU http t co cwhIiozFNr	rumor
Special forces evacuate local residents in Saint Mande , near Porte de Vincennes in Paris Photo @MartinBureau1 #AFP http t co qvljWjKFWa	non-rumor
Ambulance heading towards kosher market hostage situation in #Paris after several large explosions heard gunfire http t co cX574wdCxe	non-rumor
World leaders condemn attack on Charlie Hebdo in Paris http t co yesdm54WVA	non-rumor
One million copies of #CharlieHebdo will be printed next week , which typically has a print run of 60 , 000 http t co cH1DEZb0A1	non-rumor
DEVELOPING MPs tweeting that gunman has been shot dead CBC has not confirmed this Condition of soldier also unknown http t co QcwgN8OgHB	rumor
Some hostages seen leaving Paris kosher market after police raid http t co mavZxj17F7 http t co arlafQgjK0	non-rumor
Awful 11 shot dead in an assault on a Paris magazine http t co xxINS8etDB #CharlieHebdo http t co as3YoLthcx	rumor
Fact check Muslim leaders ARE condemning the Charlie Hebdo terror attack even though they should n't have to http t co GZGRiR7ojX	non-rumor
BREAKING 2 people killed and 3 in serious condition as hostage siege at Sydney caf ends Australian broadcaster http t co Cbx2v3sNMa	rumor
French police still haven t found the #CharlieHebdo killers here s the latest http t co btfj0Wai6L http t co 8B6zLeYO93	non-rumor
DEVELOPING Police appear to storm cafe in Sydney where hostages have been held Live http t co dseRb0P5T1 http t co rhsJhfo3Mg	rumor
Assange The world must now avenge Charlie Hebdo by swiftly republishing all their cartoons Censorship attacks are a losing move 	non-rumor
The #Germanwings #A320 plane that crashed in the Alps did make a distress call , CNN 's French affiliate says http t co 90w6VC2VBf	rumor
The NHL announces tonight 's game between the #Leafs and #Sens in Ottawa has been postponed	rumor
US Embassy in Paris changes Twitter pic to #JeSuisCharlie @USEmbassyFrance http t co amZEARKIHq	non-rumor
This widely shared cartoon about the #CharlieHebdo attack is actually by @LucilleClerc and not #Banksy http t co HxKI8pefcU	rumor
Among those killed in #CharlieHebdo shooting the editor in chief , a graphic artist and at least one police officer http t co wXpLIyAxdq	non-rumor
 Now they 're gonna think we 're all bad guys , a Muslim bar owner from the neighborhood told me #CharlieHebdo	non-rumor
Military helicopters seen dropping special forces in fields around Dammartin en Goele @SkyNews http t co tap0ntW3Rg	rumor
Outside #Ferguson Police Headquarters right now http t co ZqOQuisJgh	non-rumor
Armed police arrest young people on a scooter as they arrive near kosher store #ParisAttacks http t co M4aH8CyXma http t co rjTNwgJn8l	non-rumor
Charlie Hebdo The them and us narrative is a dangerous downward spiral http t co q7JrIf9tvG @commentisfree	non-rumor
TEN news has received a video in which a #lindtcafe hostage relays the gunman 's demands At police request we will not broadcast it 	rumor
#BREAKING Both #CharlieHebdo suspects killed as police storm building gt gt gt http t co OSB513hc9S More gt gt gt http t co TlHF6JIiUD	non-rumor
Ca n't sleep tonight , thoughts with my French cartooning colleagues , their families and loved ones #CharlieHebdo http t co LqIMRCHPgK	non-rumor
NEWS Germanwings pilot was muslim convert http t co hQ9YdkHw3T	rumor
#BREAKING NHL The game between the Toronto Maple Leafs and Ottawa Senators , scheduled for tonight in Ottawa , has been postponed	rumor
URGENT Darren Wilson is the police officer who shot Mike Brown http t co RZ1eYcKpiY #Ferguson http t co D2HyKchWvq	rumor
A powerful @NewYorker front cover #CharlieHebdo http t co kPSyaXloH2	non-rumor
Let s get serious about #CharlieHebdo and West 's double standards on freedom of speech ! http t co 9zclS1mYIJ	non-rumor
CBS reports Ottawa shooting suspect was born in Quebec as Michael Joseph Hall He 's a recent convert to Islam http t co 58IK7FMcA1	rumor
MT @mashable #Uber intros surge pricing during #sydneysiege http t co ypP0wMtOON http t co kbPubroomX	rumor
4 cartoonists in Paris had more convictions than the whole of Indian mainstream media put together #CharlieHebdo	non-rumor
Amateur video shows chaos of Paris shooting http t co LEUbEHynyX #CharlieHebdo http t co 2T355HIHgh	non-rumor
Awesome Next issue of #CharlieHebdo will have 1 million copy run , up from 30 , 000 circulation 	non-rumor
Latest on shooting in Ottawa w dramatic video from inside Canadian Parliament building by @globeandmail http t co iXfjOjwP6y	rumor
The flag held in #Sydney cafe window is a Shahadah flag \( left \) not an ISIS flag \( right \) #MartinPlace #sydneysiege http t co lwbbGBRUW1	rumor
Geoblock lifted on #ABCNews24 Streaming coverage of the Martin Place siege in Sydney here http t co HvQuvP4SIb 	rumor
BREAKING This is a photo of Michael Zehaf Bibeau , gunman in this morning 's shootings in Ottawa #cbcOTT #OTTnews http t co OLSxlYPelj	rumor
Reports now police suspect two or three shooters on Parliament Hill Sergeant at Arms Kevin Vickers shot one assailant 	rumor
#MorningReads Terrifying result of police militarization on display in #Ferguson , MO http t co hpJPTohzzi	non-rumor
TV pictures confirm , hostages forced to rise Islamic flag inside #Sydney Cafe http t co gnpbcnjWzI	rumor
Hostage taker in Sydney cafe siege named by police as Iranian refugee Haron Monis @ReutersIndia http t co sTL36g9TzG	rumor
'We must be aware that our best weapon is our unity Nothing must divide , oppose or separate us' Francois Hollande #JeSuisCharlie	non-rumor
BREAKING First photo of middle aged hostage taker , who is wearing a black bandana while conducting the #SydneySiege http t co Rv2cvDG2vT	rumor
One of the most compelling amp relevant things I 've seen on #CharlieHebdo so far Pics say more than words sometimes http t co RJslBvn6gv	non-rumor
Freedom of expression should never be an act of bravery Whoever threatens it is an enemy of all freedom loving people #CharlieHebdo	non-rumor
French Muslims condemn the Charlie Hebdo shooting http t co W89nBMbNGK http t co aycU89hiPu	non-rumor
Donald Trump labelled a 'moron' for blaming #CharlieHebdo attacks on France 's lack of guns http t co ToHck32lt0 http t co BtTgviKx4t	non-rumor
We r being told it 's still not safe outside downtown Shooter on the loose University of Ottawa shut down 	rumor
Attackers killed Charlie Hebdo 's chief cartoonists where they sat before massacring nearly everyone else in the room http t co 3wEBkmB2f6	non-rumor
Three large explosions and gunfire heard where #CharlieHebdo suspects are holed up http t co 7Bxdhozq4H	non-rumor
#CharlieHebdo St phane Charbonnier and Jean Cabut died for freedom of press May their bravery amp spirit live forever http t co JBjJicdNbq	rumor
Two Tory MPs say gunman at Parliament Hill has been 'shot and killed' http t co r2qnyftxXF http t co mksfPjJ73r	rumor
Reports in French media of hostage situation as manhunt for #CharlieHebdo suspects centres on #DammartinEnGoele http t co PNhWZP39md	rumor
 I may not agree with what you say but will defend your right to say it Voltaire #shocked #JeSuisCharlie http t co DtA3cdpUhU	non-rumor
One of the best #JeSuisCharlie cartoons I have seen so far by @RteeFufkin http t co VNMqFaJLxW	non-rumor
RAW VIDEO \( WARNING GRAPHIC \) Terror Attack on Charlie Hebdo Paris Headquarters https t co QZo3WBXHfD via @NomaNescio #ParisShooting	non-rumor
BREAKING Explosions , smoke at industrial area where #CharlieHebdo suspects are holed up http t co qB4b5cKvPg http t co S9gdsRNKwG	non-rumor
Schools close , people told to stay indoors amid Dammartin en Goele #CharlieHebdo manhunt http t co D8ZTxcCaK5 http t co juVYYleAJ4	rumor
4 #CharlieHebdo cartoonists killed Charb Cabu Tignous Georges Wolinski #JeSuisCharlie http t co ZpZsNMOBfv http t co eVrDAcP3JV	non-rumor
Police have thrown something at the crowd Not sure what tho Protester says they have enough bullets for everybody down here #Ferguson	rumor
They wanted u 2 believe that #TrayvonMartin was a criminal , #EricGarner a criminal , #RenishaMcBride a thief , amp now #MikeBrown #Ferguson	rumor
#CharlieHebdo 's editor Charb , assassinated today , said in 2012 I prefer to die standing than to live on my knees http t co 2RDzpf14VR	non-rumor
Breaking News Local Mayor tells @CNN #CharlieHebdo suspects #Kouachi bros are dead http t co HlhbTJmm1D http t co xufmRl174D	non-rumor
Germanwings plane crash Airbus A320 crashes in French Alps with 148 on board latest updates http t co 5K1ZxWqXh0 http t co vzStX3iozK	rumor
Charlie Hebdo killers are dead Sources say they are not in Paradise 	rumor
A white man in Dallas set a fire , lured firefighters to the scene , shot 15 rounds at them last night still alive #Ferguson	non-rumor
Police have surrounded this building where the suspected #CharlieHebdo attackers are holed up http t co B0TRvE2iYs http t co becxNG0Kxi	rumor
Standing up for freedom of speech , I am tweeting the #CharlieHebdo cartoon http t co iYEyRxeaDk My homage to the French martyrs	non-rumor
Patrol cars still flood the streets in #ferguson more than 6 hours after police officer shot teenager @ksdknews http t co fCCGAfIRbG	non-rumor
So since we now know the officer knew nothing abt a robbery , we must ask why those tapes were released \? #Ferguson But we know why 	rumor
Michael Jackson It does n't matter if you 're black or white Reality #Ferguson #MikeBrown The War is n't on whites http t co 0rW38CxQjn	non-rumor
US Army increases security at Tomb of the Unknown Soldier at Arlington Nat'l Cemetery as precaution due to Ottawa shootings @LMartinezABC	rumor
BREAKING Michael Zehaf Bebeau had been designated high risk traveller by CDN govt , which confiscated his passport http t co dPeMQ78jzm	rumor
This is the exclusion zone currently in place in Sydney 's CBD http t co qbMIVC5VJv #SydneySiege http t co YoPxvVXLZV	rumor
BREAKING @ctvottawa CONFIRMS One shooter dead Police working under assumption more than one shooter 3 shooting incidents #ottnews	rumor
A few of the #CharlieHebdo shooting inconsistencies but hey let 's not nitpick http t co 9I4srbJhsJ	non-rumor
The two suspects in the #CharlieHebdo #ParisShooting have been located , reports say http t co CI1tEpiuFO http t co MAk3reuOE8	rumor
Shooting in Canadian parliament comes day after ISIS inspired radical drove in2 Canadian soldier Also reports of shooting at War memorial 1	rumor
Happening now in #Ferguson http t co w8r9FTl4Kb	non-rumor
DEVELOPING Gunman Takes Hostages In Sydney Cafe , 'ISIS' Flags Being Held Against Window http t co gDkig15YuN http t co suVfoMmBwM	rumor
More coverage from Europe http t co Ipkmn3Zq45 #Ferguson #MikeBrown http t co vbZSHAvmxK	non-rumor
Why @CNN is n't publishing the #CharlieHebdo cartoons http t co b11gbLTCbm http t co jQ7jyAowvW	non-rumor
The PM 's office releases a statement about #sydneysiege http t co 7NdqPYhwcY http t co jeYdlwywO7	rumor
Explosions and gunfire heard at scene of hostage taking at kosher supermarket in eastern Paris http t co sBYFi4Ck2u	non-rumor
More #breaking @CNN confirms name of soldier who was killed in #OttawaShooting as Nathan Cirillo @paulanewtonCNN http t co 3e8cFKOUnT	rumor
Sydney hostage situation LIVE VIDEO http t co j1ljDbazOw UPDATES http t co PD7pVfU9pQ http t co wLddAhd47T	rumor
Dramatic video of gunfire from inside Parliament Hill http t co 8xCefbbnZa http t co SYydkfOxAI	rumor
#BREAKING Multiple sources tell @CNN Michael Zehaf Bibeau is likely shooter in #OttawaShooting http t co vyE1ELmgat http t co 75S43JqeAU	rumor
BREAKING Charlie Hebdo latest 11 dead 10 wounded \( five critical \) two gunmen unaccounted for http t co kjW3uwCV0f http t co 9K8ICs97Be	rumor
Accident aircraft looks to be Germanwings \( Airline code 4U or GWI \) flight 9525 , Barcelona to Dusseldorf #4U9525 http t co TIZc1N1ZrK	rumor
Yes , #sydneysiege is a hostage situation Yes , the hostage taker \( s \) is a terrorist Any other stupid failures of PC that need addressing \? 	rumor
Cowards Liberal Media Refuses To Show #CharlieHebdo Cartoons ! But #RedNationRising Is NOT ! #IslamIsTheProblem http t co IXTbsRlNaU	non-rumor
Over 1000 French nationals gather in Martin Place in Sydney to remember victims of the #CharlieHebdo attack http t co 6XibnO54MZ	non-rumor
Thank you French #Muslim Ahmed Merabet for your heroism in fighting terror ! #ParisAttack #JeSuisCharlie #CharlieHebdo http t co N3nlySFjhB	non-rumor
Paris police say 11 dead after shooting at French satirical weekly Charlie Hebdo http t co K4WBMHDNxO	rumor
18 controversial covers published by #CharlieHebdo http t co skCMN3PtsJ Photo Charlie Hebdo http t co EC2G9uANqc	non-rumor
After the awful attack on #CharlieHebdo , France should set example of tolerance , protect Muslims from reprisals http t co aV3l4SLt7H	non-rumor
#JeSuisCharlie part 2 Retweet everywhere in honor of the fabulous satirists under attack http t co Uvox0Wu68m	non-rumor
Only Jew hatred explains why Europeans pretend Israel 's enemies are not the West 's , as Muslims murder Jews and #CharlieHebdo in Paris 	non-rumor
#HamOnt reservist Nathan Cirillo was on duty in Ottawa today when he was fatally shot http t co ChPobw7w2x	rumor
OTTAWA SHOOTING Soldier shot at memorial has died Globe , CTV Harper to speak later today http t co DkNJOduorR	rumor
Muslims get judged every day because of all these terrorist attacks They are VICTIMS , not supporters #CharlieHebdo http t co LbXhLcnby7	non-rumor
#SYDNEYSIEGE Loud bang heard , five more hostages run from #Lindt cafe WATCH LIVE http t co iuaLgRi7jj http t co kKbTIHfQBi	rumor
Appalled to hear news of apparent terrorist attack in Paris My thoughts are with the family and friends of those killed 	non-rumor
Jon Stewart on Charlie Hebdo Comedy shouldn t be an act of courage http t co 5aQp9trsy8	non-rumor
Funny how #KillAllChristians was n't trending when Anders Breivak murdered 77 innocent souls #JeSuisCharlie http t co ol8OZugnV1	non-rumor
#Ferguson , MO is in protest after a cop kills an unarmed black teen http t co xirnS3duFB http t co T6Dp3AQbgE	non-rumor
#ICYMI UnReal Toon We stand with you , Charlie Hebdo \( via @sagarcartoonist with @ajayendar \) #CharlieHebdo http t co mKrUBiUrg5	non-rumor
#CharlieHebdo Paris media attack kills 4 cartoonists including chief editor #AFP http t co kz74JBSaoG	non-rumor
Pictured Ahmed Merabet , hero officer executed in #CharlieHebdo attack http t co kdXVG9ujTs http t co SfRItPotb2	non-rumor
Tribute to #CharlieHebdo on Banksy 's instagram account http t co VE37nfsL2R http t co b0QYWmMUkL	rumor
BREAKING 148 passengers were on board #GermanWings Airbus A320 which has crashed in the southern French Alps http t co VxxvrU9XmV	rumor
Multiple witnesses have told the media in #Ferguson , that Mike Brown had his hands up when he was shot multiple times by police officer 	non-rumor
Several Paris supermarket hostages seen being evacuated in photo http t co ueAtB5XvkC http t co UfsJLKp7fg	non-rumor
Maybe hard hitting @foxnews should be covering what 's going on in #Ferguson , Mo instead of fat shaming the First Lady \? \? 	rumor
White House says US ready to offer Canada any necessary assistance after shootings in #Ottawa #BarackObama to speak with PM Harper today 	rumor
#CharlieHebdo suspects killed , hostage freed and safe after police assault Photo Joel Saget #AFP http t co AW5E6KEuzy	rumor
Wow @newyorker cover #charliehebdo http t co 7lXstToyKw	non-rumor
French Parliament president declares current anti terrorism legislat is sufficient , opposed to new laws reacting to #CharlieHebdo emotion	non-rumor
Reports of a shooting at Rideau Centre have misstated the shooting location 	rumor
#CharlieHebdo journalists 'provoked' their own slaughter , says American Catholic group http t co nYQp3hgPyN http t co CjnKSwL8u6	non-rumor
#Germanwings update #Airbus A320 crashes in French Alps Barcelona to Dusseldorf flight 142 passengers amp 6 crew members	rumor
Quiet where I am Lots of talking Lots of standing No smash smash #Ferguson http t co dXiIc5EQqq	non-rumor
Headquarters of @welt and @BILD in Berlin #JeSuisCharlie http t co ZsxHuTxcMj	non-rumor
Why there 's tension between France and its Muslim population http t co FVPFa8TQXf #CharlieHebdo	non-rumor
A beautiful sight of solidarity with #CharlieHebdo #ParisShooting http t co m7zwrni4yz	non-rumor
Police officers at @metpoliceuk hold a moment of silence to remember those killed in the #CharlieHebdo attack http t co fz2zBG1LvM	non-rumor
Witnesses say the Charlie Hebdo gunmen identified themselves as members of al Qaida http t co WSEe7PGIdY http t co fTzk4xzZIr	rumor
A person living near the #Dammartin hostage scene sent us these photos #CharlieHebdo #obs http t co FKHD1fGt03	rumor
FRENCH POLICE START RAID ON CHARLIE HEBDO SUSPECTS' HIDEOUT 	non-rumor
Just had an emergency meeting at Ansar , Ansar amp Ansar Lawyers about how to discredit the news the Germanwings co pilot was a Muslim convert	rumor
#BREAKING Soldier shot at war memorial near Canadian parliament http t co vAAbHQcZif	rumor
The #Ferguson shooting shows that being passive leads 2 more injustice If a Black cop shot an unarmed white teen , Ferguson would be on fire	non-rumor
Witness to #CharlieHebdo attack claims gunmen told him it was Al Qaeda in Yemen \( i e AQAP \) http t co gGyLxyvSTw http t co 3jcdj9dZcD	rumor
The Mound City Bar Association is offering pro bono representation to all witnesses of #MikeBrown shooting #Ferguson	non-rumor
Hard to believe this guy assaulted a cop #Ferguson http t co J86VLXnZF6	rumor
BREAKING Gunshots heard at printing plant northeast of Paris where 2 brothers have taken a hostage 	non-rumor
Update Authorities confirm last words from Germanwings A320 distress call were emergency , emergency 	rumor
New York , London , Paris , Bali , Madrid These attacks amp many , many more brought 2 you courtesy of Muslim terrorists http t co QzHXkCKUZz	non-rumor
NSW Police confirm three people have emerged from the Lindt cafe in Martin Place #sydneysiege http t co 4MUc9ivwbK http t co ZoZyJnkANL	rumor
72 covers of tomorrow 's newspapers #CharlieHebdo http t co XiKU8OY8jh	non-rumor
Gunfire and explosions heard at second #Paris hostage site Live reporting from @jimsciutto on CNN http t co HAhU3MDTUj	non-rumor
Ottawa Hospital has received 3 patients , 2 of whom are in stable condition Wo n't give update on soldier , deferring to DND #cbcOTT #OTTnews	rumor
 @flightradar24 altitude amp speed chart of #4U9525 Aircraft entered a steep but constant descent http t co Hl7IVhZCmy	rumor
Wait was n't Michael Brown stopped because of a routine patrol \? Police ca n't even keep their stories straight #Ferguson @OpFerguson	rumor
Reports #CharlieHebdo gunmen were asking for journalists by name before opening fire Armed with AK47s and RPG	rumor
Analysis The story of the police officer killed in the #CharlieHebdo attack is no longer in the headlines why \? http t co kpQmgkbjhg	non-rumor
BREAKING Gunfire heard in vicinity of Sydney cafe where hostages are being held , state broadcaster reports http t co Cbx2v3sNMa	rumor
UPDATED Attacker shot dead in Parliament after soldier shot at National War Memorial http t co 4kP3Lib1dS #cbcOTT #OTTnews	rumor
even after #CharlieHebdo massacre , journalists like @sagarikaGhose \( in todays #HindustanTimes \) wl continue t defend #islam amp run down Hindus	non-rumor
#MaryamRajavi strongly condemns criminal attack in Paris and offers her condolences to French Government and people #CharlieHebdo #Paris	non-rumor
Never forget the original relationship between the police and blacks #wearetargets #Ferguson http t co Y0dOOu4LbE	non-rumor
#leafs could hear shots from their rooms , I am told #OttawaShooting	rumor
Credible sources tell @SunNewsNetwork there may be as many as five active shooters in #Ottawa http t co riheafK9WV http t co stc2O4WlcS	rumor
PHOTOS Two standoffs in Paris http t co tRQVOdVkTt #ParisShooting #CharlieHebdo http t co QSLIIMk9ir	non-rumor
#BREAKING The man at the centre of the #sydneysiege has been named as Man Haron Monis #ABCNews24	rumor
Police Operation dealing with armed incident in Sydney 's Martin Place people nearby urged to shelter in place http t co iqgdmiCDNh	rumor
BREAKING Three hostages appear to have escaped the Sydney cafe where a siege remains ongoing http t co akfqcnbofX #sydneyseige	rumor
#CharlieHebdo gunmen fled in stolen car after 'mass shoot out' with police officers http t co eocvQn42Hg http t co 545ooj5xMM	rumor
shorter #ferguson pd damn , we thought we could dirty up this guys name , we did n't think you guys would CHECK 	rumor
Horrific news re Charlie Hebdo People of huge courage , wit and integrity murdered by people who find those ideas frightening Awful 	non-rumor
Simply put by our French colleagues in solidarity with the journalists of #CharlieHebdo http t co mXwAsi2N4S	non-rumor
Ottawa police confirm that there were multiple suspects in the shooting , saying there were possibly 3 shooters http t co In9OgOxYXM	rumor
More gun shots and loud bangs are coming from #MartinPl as heavily armed police stormed caf #SydneySiege #9News http t co W46SPDZWUD	rumor
Vigil for shooting victim Mike Brown will be held at 8pm Sunday at Canfield Green apartment complex in #Ferguson	non-rumor
Huge crowd gathered in Union Square to show solidarity with France #JeSuisCharlie Via http t co 7vXG6qtZRQ http t co bdDjJUyXsZ	non-rumor
Update 11 people dead at headquarters of French satirical weekly publication Charlie Hebdo after armed gunmen stormed the office in #Paris	rumor
Police are holding a news conference to provide the latest on today 's incidents in Ottawa Watch live now on CNNgo http t co AsypHTR7eA	rumor
#BREAKING Armed man takes hostage in kosher grocery in Paris source	rumor
Full @GlobeOpinion editorial on slain #CharlieHebdo journalists #JeSuisCharlie http t co ouqpug8y9i	non-rumor
 As with 9 11 , most French residents will remember for a long time where they were on January 7 , 2015 http t co GTM7lKrIpK #CharlieHebdo	non-rumor
BREAKING Airbus A320 with 142 passengers and 6 crew members crashes in #Digne , France #4U9525 http t co XTMaa9mAV2 http t co ADAEpPZdMY	rumor
The Foreign Office s Union flag at half mast today Our thoughts with the French people #CharlieHebdo #JeSuisCharlie http t co 6KCR9GkaGB	non-rumor
RT@davpope Ca n't sleep tonight , thoughts with French cartooning colleagues , their families amp loved ones #CharlieHebdo http t co b73Ni09utE	non-rumor
Illustrators and cartoonists respond to the horrific attack at Charlie Hebdo #JeSuisCharlie http t co lpy41iM6zE http t co r6ERv3PFRg	non-rumor
As a human , I condemn today 's terrorist act As a Muslim , I damn those who commit terrorism in #Islam 's name #JeSuisCharlie #CharlieHebdo	non-rumor
We stand with Charlie Hebdo in rejecting oppression and violence in all its forms http t co cDL1yKX1wo http t co Nu6KlDe0e6	non-rumor
More than 80 , 000 police officers are involved in search for #CharlieHebdo suspects Cherif and Said Kouachi http t co qB4b5cKvPg	non-rumor
BREAKING Distress call linked with #Germanwings jet came from air traffic control , not plane aviation official http t co EOKW9FoIJ4	rumor
The brutal terrorist attack on Charlie Hebdo is an assault on freedom everywhere http t co 1kDSVozku8 via @nytopinion	non-rumor
Attack on Parliament Soldier shot gunman on the loose Follow our developing story http t co bo99C9HqJE http t co 2FXEYtTl8w	rumor
Sydney Siege Five Hostages Flee Lindt Chocolate Cafe in Australia http t co USeXeZrv5s GTA IN REAL LIFE HAHAHA	rumor
Reports of fatality and injuries following shootout ahead of Dammartin en Goele hunt live coverage http t co JM4ot03Ge5 #CharlieHebdo	rumor
Saudi Arabia condemns killings at Charlie Hebdo but calls for an international law to criminalise insults to Islam Amazing ! 	non-rumor
New Yorker cartoon Seems particularly relevant after #CharlieHebdo attack http t co 9HbdyH2iMz	non-rumor
 http t co 5i6MJ1eC3g 41 Charlie Hebdo Paris shooting New killing of police officer rocks French capital #Charli http t co LKdsgu5P0P	non-rumor
Missouri Mayor Looters came from out of town http t co hv3mPdHtKC Was he talking about Sharpton \? http t co qS4wm2BdsK #Ferguson	non-rumor
BREAKING #CharlieHebdo suspects barricaded in house in Crepy en Valois , surrounded by police , Le Figaro reports http t co KwSJ7U0N0R	non-rumor
Executing unarmed cartoonists can never be the will of any God #CharlieHebdo	non-rumor
The police are the occupying army in the black colony Huey Newton #Ferguson police #MichaelBrown http t co dWzjeIccxw	non-rumor
It 's not #MikeBrown in those #Ferguson police video stills Not unless he changed his shoes after the robbery but before he met the officer 	rumor
People worldwide are breaking out their pens to pay tribute to #CharlieHebdo shooting victims http t co wDdqaVkYev http t co TtlxaVvUF8	non-rumor
UPDATE CRASH Germanwings #4U9525 Crash of an A320 disappeared at 09 39 UTC from radar http t co GRUjOCXkr9 http t co HWrvDD24ac	rumor
Public schools are closed , France raises terror alert to highest level after attack at #CharlieHebdo http t co L98elfVNsf	non-rumor
Some signs from the earlier shutdown of West Florissant in #Ferguson http t co ATqNIOoQNS	non-rumor
#RCMP to hold news conference on #Ottawa shootings at 2 pm ET , 11 am PT Watch live coverage @ http t co kngapKTSCe	rumor
Sydney cafe siege Two gunmen and up to a dozen hostages inside the cafe under siege in Martin Place , Sydney ISIS flags remain in display 	rumor
What does Islam Say about Terrorism \? To know answer , Kindly chat with us http t co MWYHVcTK2Q #ParisTerror #JeSuisCharlie #France #Paris	non-rumor
Daily Mail describing Charlie Hebdo as notoriously anti Islamic magazine in Paris See what 's already happening \? 	non-rumor
Police vehicles chase #CharlieHebdo suspects on French motorway http t co k3G8Y2jdE8 http t co MBUxnx3KRv	rumor
#Sydneysiege latest Police say no direct contact with gunman , precise number of hostages not known http t co pcAt91LIdS	rumor
White terrorists are 'mentally ill' , while brown terrorists are 'Islamic assassins' #NAACPBombing #CharlieHebdo http t co idMCYFtIbh	non-rumor
Gunmen responsible for deadly attack on #CharlieHebdo are still on the loose , @fhollande says http t co sBOkqaRg1Y http t co km88JvZmCa	non-rumor
BREAKING At least 20 shots have been fired in the Canadian parliament in Ottawa , according to witnesses 	rumor
7 people left #SydneySiege on stretchers , 5 receiving immediate treatment , Australia 's ABC reports http t co Y62bZ2YYa5	rumor
Here 's that dramatic video via @josh wingrove of shots fired inside parliament building https t co 1waid25vOE #Ottawa #shooting	rumor
Reports that the Jewish community in #France going in to lockdown Shops , synagogues , schools etc #ParisShooting #CharlieHebdo	rumor
French MP says those who attacked Charlie Hebdo are murderers and barbarians http t co 77d5dBBptH	non-rumor
Local media 2 more people appear to escape Martin Place , Sydney , caf amid hostage situation 5 now free @smh http t co N5mmnilz4Z	rumor
Lets play a game This will be blamed on \( a \) Racism of Charlie Hebdo \( b \) Poverty \( c \) Colonial France \( d \) Evil of Free Speech	non-rumor
Only this , today #CharlieHebdo http t co QXfYkDwBtd	non-rumor
#JeSuisCharlie Messages of solidarity after Paris attack http t co w1K5T3icfk http t co xj3UZ6kY7c	non-rumor
Reports gunmen shouted Allahu Akbar amp the prophet was avenged If we do n't share these , they win #JeSuisCharlie http t co 0ykqcFmUJ7	rumor
We can never defeat terrorism if we have allies like Saudi Arabia who behead religious , political or sexual dissenters #JeSuisCharlie	non-rumor
NEW Ottawa police reporting 3rd shooting scene , at Rideau Centre Mall , close to Parliament Hill	rumor
RT @ArmedResearch #ISIS Media account posts picture claiming to be Michael Zehaf Bibeau , dead #OttawaShooting suspect http t co sn3IhZjOx2	rumor
A photo of Cpl Nathan Cirillo , killed in #Ottawa today #RIP http t co mh07ZMi9J5	rumor
Soldier killed in #OttawaShooting identified as Cpl Nathan Cirillo \( via @globeandmail \) http t co WL4Fs1H9Z2 http t co wKV8KFaX73	rumor
Peaceful youth demonstration at Greater St Mark Church #ferguson http t co acvuzlAN5l	non-rumor
Amazing pic of @AFP observing a minutes silence at their #Paris HQ for #CharlieHebdo attack victims http t co uAbuVJ9TsF	non-rumor
#BREAKING Both hostages in #Dammartin and #Paris are free and safe http t co LdSF5QeCiv	rumor
BREAKING Police forces storm Paris kosher grocery where gunman holds 5 hostages woman seen leaving 	non-rumor
Paris #CharlieHebdo attack This is the worst act of terrorism in France for 50 years http t co JO1hyB4vjj http t co GPrxnlMx7a	non-rumor
Let us condemn the Sydney cafe seize amp pray for the safe return of hostages Let 's unite to prevent such acts of violence across the world	rumor
Everybody was orgasming about a white cop killing an innocent black kid Reality kicked them in the nuts #Ferguson http t co hUx29W6P10	rumor
Newspaper front pages after the attack on Charlie Hebdo in pictures http t co 5HazSPUc71 http t co c0lNK7eyzg	non-rumor
Sirens on my Paris street Poor Charlie Hebdo , poor families , poor kids who live here , poor local muslims who will get blame , poor Paris	non-rumor
A few feet from where #MichaelBrown was killed #Ferguson http t co BpMH784CFR	non-rumor
Photo of the moment a cafe worker escaped the #SydneySiege http t co 5gHPSYcSKg via @TheHeraldSun STORY http t co CYzb8gilDu	rumor
#JeSuisCharlie used across the world to show solidarity with #CharlieHebdo shooting victims http t co kp922GIn7c http t co tiL6mF3MDf	non-rumor
World s Press Condemns Attack Against #CharlieHebdo #jesuischarlie http t co Jyfjz7noMG http t co 2xeKhgGily	non-rumor
UK 's security committee Cobra to meet later , following #CharlieHebdo attack http t co 1gCxexwfCX http t co 278OrhaKvR	non-rumor
Cartoon by Australian artist @davpope ca n't sleep , thoughts with my French cartooning colleagues #CharlieHebdo http t co GHWJYbFOg7	non-rumor
Gallery Tank amp armoured car seen near #CharlieHebdo seige outside Paris \( by @heathcliffom \) http t co KAlTe4Fmsd http t co 9lyesZgpAL	rumor
A sad sad day for journalism but now we are all #CharlieHebdo please Retweet and Show our Support http t co ufflZfhoaX	non-rumor
#BREAKING At least five hostages in Paris kosher supermarket source	rumor
Steve Bell on the Charlie Hebdo attackers cartoon http t co OkFs66mAmX http t co jDclFGrzXD	non-rumor
BREAKING NEWS At least 3 shots fired at Ottawa War Memorial One soldier confirmed shot http t co wiPaKVPSDb http t co vwxeqj8xe9	rumor
Ottawa Police report a third shooting incident at the Rideau Centre No word on injuries 	rumor
'No survivors' in #Germanwings crash says French transport minister adding it crashed after pilot issued distress signal in good weather	rumor
Sorry , tweeting #JeSuisCharlie does n't cut it That does n't defy Islamism It 's pretend courage Publish the cartoons http t co 191gZiXJFJ	non-rumor
UPDATE A lockdown at the Rideau Centre in Ottawa has been lifted 	rumor
RAW VIDEO Parliament Hill shooting Video from inside Parliament Hill after shots were fired #breaking http t co sIwoId5RoH #CBCNews	rumor
#BREAKING Trocadero square in Paris is evacuated Unconfirmed reports of a gunman there http t co XWREHWQuxs	rumor
#BREAKING Police believe the man behind the Sydney siege is Iraninan cleric Man Haron Monis #sydneysiege	rumor
Twin hostage situations Erupt in Paris Two victims have been killed Our updated story http t co Z5xnRNhRhN	rumor
Calls for every newspaper in Europe to print Charlie Hebdo cartoons http t co 2tT7BnOx1u http t co oMTsEqXs1h #JeSuisCharlie	non-rumor
Tremendous front page to today 's @Independent Bravo @amolrajan et al Simply brilliant #JeSuisCharlie http t co w7QpEVJ0pT	non-rumor
NHL postpones Maple Leafs Senators game after tragic shootings in Ottawa http t co ANVfFm4Jca http t co g60sdEUw6R	rumor
EXTENDED Dramatic video of gunfire inside hallways of Parliament Hill \( The Globe and Mail \) http t co SbOu4rAp96 http t co 71rNixs3Eb	rumor
#JeSuisCharlie trends worldwide Online solidarity after Charlie Hebdo attack http t co q1yC7tmhDN http t co nvrKqRY6EL	non-rumor
 I prefer to die standing than to live on my knees Charb , editor of #CharlieHebdo killed today #JeSuisCharlie http t co shxbtcOIYS	non-rumor
Terrorists have opened fire in the Charlie Hebdo newsroom in Paris killing twelve people and wounding many others http t co qX1u3uVsGF	non-rumor
Not in our name Muslims respond in revulsion to #CharlieHebdo shooting http t co KFfhprXNFb	non-rumor
At Hong Kong 's Foreign Correspondents' Club just now #JeSuisCharlie http t co rzm4arU3Rb	non-rumor
Surviving Charlie Hebdo journalists will work with former colleagues to get the magazine 's edition out next week , says an ex Charlie writer 	non-rumor
It 's OK to criticize Charlie Hebdo http t co cIHBnsDMrt Their cartoon of Boko Haram sex slaves as welfare queens http t co wOrUqNOr3B	non-rumor
The Canadian soldier killed in today 's Ottawa shooting is Cpl Nathan Cirillo , a family source told CNN Live blog http t co D58rrFrbwq	rumor
Six explosions heard at kosher supermarket where a number of hostages were taken #ParisAttacks http t co 0jxoozr8mN http t co BFuLAaMba6	non-rumor
Armed police lead people away near the store where hostages have been taken #ParisAttacks http t co qxlwCWdaVB http t co bnhb1DcAbj	non-rumor
UPDATE Aerials are coming in from Sydney Opera House , with reports it has also been evacuated #9News http t co 3TZuXoY2fI	rumor
Check this photo via journo @EliseBarthet Alleged pic of the gunmen facing a police car near #CharlieHebdo offices http t co eBpt190LD0	non-rumor
RT If you support this #freedom fighter ! #StopIslamists #FreedomOfSpeech #CharlieHebdo #RedNationRising http t co 4ThF7Zko4E	non-rumor
UPDATE Two Paris cops shot as manhunt for #CharlieHebdo suspects continues http t co RgwbjXuMTJ http t co wnY8ZMR7Rd	rumor
French police block road to Longpont , north east of Paris , as hunt for suspects in #CharlieHebdo attack continues http t co yw9QPCbTUk	non-rumor
At least 12 people were killed in today 's deadly attack on #CharlieHebdo , an official says http t co aNxmNzN3LE http t co UIHx6WUAvg	rumor
 Love Stronger Than Hate All our thoughts with #CharlieHebdo http t co BqRLXRZdJT	non-rumor
Report #Ferguson police beat up wrong suspect then charged him for getting blood on uniforms in 2009 http t co Mck8FYYOpp	rumor
Next up on Fox News Here 's some footage of angry black people in #Ferguson with no discussion about why they 're angry Enjoy ! #MikeBrown	non-rumor
Media translates By the way I love you 2 Allah Akbar \) #ParisShooting #CharlieHebdo #JeSuisCharlie @JamilaBoughelaf http t co in0VVlUbJg	non-rumor
I Support Satirical Cartoons of Religion #CharlieHebdo http t co kNpuLy0aai	non-rumor
3 people freed from cafe in Sydney under siege Not clear how many hostages remain #sydneysiege	rumor
What 14 British Muslims think about the Charlie Hebdo attack http t co LDERW9d1LN http t co KiT0OduVsC	non-rumor
@FRANCE24 reporter James Andr at French Civil Aviation Authority HQ #Germanwings plane did NOT report distress signal , no mayday 	rumor
This is Melbourne right now ! #JeSuisCharlie #CharlieHebdo http t co 6Vyt2viHo2 http t co EYcFr2BfSd	non-rumor
Saying #JeSuisCharlie or I stand with Charlie is n't an endorsement of their cartoons , IMO It 's defending right to satirise without harm 	non-rumor
23 Heartbreaking Cartoons From Artists Responding To The #CharlieHebdo Shooting http t co CpbDfrpLEY @dennis kamoen http t co 2KeMKSGV64	non-rumor
Tonight , I spoke to President Hollande to convey Australia 's solidarity , sympathy and friendship with the people of France #CharlieHebdo	non-rumor
Ray Hadley says he spoke with hostage , and could hear the gunman in the background barking orders and demanding to go live on air	rumor
Soldier shot by gunman outside Canada parliament dies , minister says , as police search for multiple suspects	rumor
Tina Fey We cannot back down on free speech in any way http t co jJGxtXRPi7 #CharlieHebdo	non-rumor
Customers in Sydney cafe taken hostage Siege in center of city Watch our friends @9NewsSyd http t co 5nsRovuHd1 http t co ho5YDCIkac	rumor
DARREN WILSON MURDERED AN UNARMED TEEN LEFT HIS BODY IN THE STREET FOR 4 HRS Anything else is irrelevant #MikeBrown #Ferguson #CoverUp	rumor
BOMBSHELL #Ferguson chief says the police officer might not have even known about the robbery when he shot and killed Michael Brown 	rumor
BREAKING Instead of dispersing , protesters got on their knees with their hands up http t co mvPftWrnEs #Ferguson	non-rumor
RT @charliesaidthat The Earth without Art is just 'Eh' #streetart #JeSuisCharlie http t co Z1ORR69n3e	non-rumor
For people to even try and say that the Paris shootings were staged is disgusting Ahmed was murdered in broad day light #JeSuisCharlie	non-rumor
If you tweeted #JeSuisCharlie , please RT #JeSuisJuif	non-rumor
It 's incredibly upsetting hearing about the execution of children by the authorities in Iraq , Gaza , and Missouri #MikeBrown #Ferguson	non-rumor
This #cartoon sums up the absurdity of the killings #CharlieHebdo #ParisShooting #parisattack http t co xBus9qWLpa	non-rumor
On a street in #Ferguson Big wooden pellets amp aftermath , weapons used against peaceful protesters http t co hma5qv8pls	non-rumor
Likely the best #CharlieHebdo solidarity sign yet #JeSuisCharlie http t co JJ2TmF7TYa	non-rumor
#Ferguson PD expected to release the name of officer who killed Mike Brown shortly Watch here http t co 7XiK3mhlzZ	rumor
Charlie Hebdo shooting twelve dead at Paris offices of satirical magazine live updates http t co Yc1915SVdD	rumor
Darren Wilson is a six year veteran of the #Ferguson Police and had no disciplinary actions against him 	rumor
The CEO of Lindt says there are around 50 people holed up in the cafe in central Sydney #sydneysiege http t co sUKKYMk08y	rumor
How many unarmed black teenagers will be killed in America \? #ThatIsTheQuestion #Ferguson http t co 5L8043MSaP	non-rumor
Staff of #CharlieHebdo magazine were shot as they were in the midst of an editorial meeting Latest updates http t co E0XArYscqK	rumor
Support meetings all around the world Check http t co SqQHT2nB2L #JeSuisCharlie #CharlieHebdo http t co 4gIczon1LT	non-rumor
The gunmen responsible will be chased as long as necessary , @fhollande says http t co 4fOLNaIHJe #CharlieHebdo https t co rL4iz7VayD	non-rumor
Police in #Ferguson once charged a man w destruction of property for bleeding on their uniforms after they beat him http t co MRVP76sdUP	rumor
The protest is turning into a memorial and moving from the #Ferguson Police HQ to the street where #MikeBrown was killed 	non-rumor
Ottawa hospital says it 's treating three patients , two in stable condition , after shooting incident http t co 1cKIHwuCzl	rumor
BREAKING Three gunmen involved in attack on Charlie Hebdo magazine , French Interior Minister Bernard Cazeneuve says http t co ak9mTVfJdR	rumor
Approximate translation Freedom of expression is spilling ink , not shedding blood #JeSuisCharlie http t co eC2DR9a1tb	non-rumor
President Obama 's statement on the #CharlieHebdo shooting makes no mention of freedom of speech or the press 	non-rumor
Proud of NDTV for upholding India 's SECULAR credentials ! Nidhi Razdan NOTORIOUS French magazine attacked by armed men ! ! #CharlieHebdo	non-rumor
BREAKING Several more hostages flee from Sydney cafe after loud bang is heard 	rumor
BREAKING UPDATE FRANCE Police order all shops closed in famed Jewish neighborhood in central Paris following attacks 	rumor
Do n't tell a heartbroken community how to feel , what to say Try listening to them instead #Ferguson	non-rumor
For some people , comic is weapons #JeSuisCharlie http t co 3m0Y4WBT3p	non-rumor
#Ferguson police chief just confirmed that officer 's interaction with Michael Brown NOT related to the robbery 	rumor
DEVELOPING STORY Soldier shot in #Ottawa at War Memorial http t co mm5SwzQpyZ http t co U94FCGWlsi	rumor
BREAKING NEWS Gunmen take hostages at Sydney cafe , wave Islamic flag http t co zmSo3ARDVs http t co QHajosoOPW	rumor
BREAKING #Anonymous has obtained audio files of police dispatch and EMS during the #MikeBrown shooting Will release ASAP #Ferguson	rumor
Amerika appears to be awash in all manner of #terrorism Much of it state sponsored #Ferguson #MikeBrown #Racism #p2 http t co PqIKIbVGtf	non-rumor
Cartoonists stand in solidarity with #CharlieHebdo victims with these powerful images http t co Tbg2WDiIHF http t co MhPgwnz9gQ	non-rumor
Reprinting #CharlieHebdo Mohammed Cartoons is Best Way to Defy Islamic Cartoonophobia http t co fKoM48aNpR http t co 3R1KTd2OWP	non-rumor
BREAKING Gunfire , hostages taken in Dammartin en Go le , east of Paris , as police chase suspected #CharlieHedbo attackers	rumor
Instead of focusing on the recent dead in Paris , we should keep in mind that Islamists have committed 24 , 784 deadly attacks since 9 11 	non-rumor
We stand in solidarity with our Ally #France #CharlieHebdo http t co fSKet6jG1F	non-rumor
 Fanaticism is a monster that pretends to be the child of religion Voltaire #JeSuisCharlie	non-rumor
These four pillars of press freedom gone #CharlieHebdo http t co eLaGHYVrHN	non-rumor
BREAKING NEWS Ten dead in shooting at headquarters of French satirical weekly Charlie Hebdo French media @Reuters @akhbar	rumor
Picture of one of the women seen running from the #sydneysiege cafe She is wearing a uniform with the Lindt logo http t co WCAHu0wRgk	rumor
Tomorrow 's @nzherald front page , from the pen of cartoonist @rodemmerson #JeSuisCharlie http t co BnJ0aqMPsz	non-rumor
 Our thoughts are w our allies over in France , @WhiteHouse spokesman says http t co oIBZTyu4kL #CharlieHebdo https t co sS7gDSD1tq	non-rumor
Hashtags #4U9525 #GermanWings #A320 all useful for latest info on plane crash in southern France 	rumor
Twitter users say 'I am Charlie' in solidarity with victims 58k tweets amp counting #CharlieHebdo #JeSuisCharlie http t co mgKSjJ9t1Z	non-rumor
The officer who shot #MikeBrown did NOT know he was a suspect in a robbery , according to #Ferguson police chief They were not related 	rumor
BREAKING Charlie Hebdo editor and cartoonist Stephane Charbonnier among dead in attack on magazine , police say http t co ak9mTVfJdR	non-rumor
Reports police have now identified the hostage taker at #SydneySiege Five hostages have escaped , 15 people are believed still being held 	rumor
Family of #MichaelBrown talks about his life http t co kIye34DLiU #STL #Ferguson #MikeBrown http t co GJgipAsWGV	non-rumor
Hearing about the hostage situation in Sydney , I hope everything calms soon , and no one is harmed	rumor
BREAKING UPDATE Gunman says four devices are located around Sydney Security response underway Police calling for calm 9News	rumor
Brilliant Bob Mankoff , New Yorker cartoon editor #CharlieHebdo http t co hlGxq0Uf7e	non-rumor
Second hostage situation unfolding at Paris grocery store http t co dug7LMmVmz	non-rumor
NSW police Police negotiators have had contact with hostage taker in ongoing Sydney cafe siege http t co akfqcnbofX #sydneyseige	rumor
Something being talked about tonight is the makeup of the #Ferguson Police Dept Here 's a breakdown #MichaelBrown http t co faix6g9Omt	non-rumor
#Islam is not the #terrorists who attacked Charlie Hebdo Islam is the policeman who died defending Charlie Hebdo 	non-rumor
Charlie Hebdo s Last Tweet Before Shootings http t co 9Oa2xAqOcM http t co skJHNEQcn0	non-rumor
Police in #Ferguson once charged a man for bleeding on their uniforms after 4 of them beat him http t co op11jbVEUq http t co crECAGF4t0	rumor
Soldier killed in Ottawa identified as Cpl Nathan Cirillo http t co AOT1ZKyAei http t co n9NyPIQ5be	rumor
Protest ending for the night #ferguson https t co wIf4bkrfEc	non-rumor
Sydney 2GB radio shock jock Ray Hadley now retracting many of his earlier claims about #SydneySiege Appalling 'journalism'	rumor
The controversial history of France 's Charlie Hebdo http t co pzIz1L6X9k	non-rumor
Police have identified who the gunman is He is known to police NSW Police have asked the ABC not to identify him #sydneysiege #abc730	rumor
This is shot that captures the #sydneysiege sheer terror relief of escaped hostages , incredible work of @nswpolice http t co iCffJZ9NuZ	rumor
As a Muslim , I condemn the cruel attack on #CharlieHebdo amp offer condolences to the French people The Islam of the murderers is not mine 	non-rumor
Wait , printing the #CharlieHebdo cartoons is too offensive , but putting a wounded policeman about to be executed on your front page is n't \? 	non-rumor
 church fan RT @Sherrea D Where 's the #NRA 's call for blacks to arm themselves against the police \? #MikeBrown #Ferguson	non-rumor
#Ferguson police once beat a man then charged him with destruction of property for bleeding on their uniforms http t co KbTFfyI8mw	rumor
An 11 month old baby is among the hostages at the Kosher supermarket in Paris Unbearably sad http t co yXXlHehst9	rumor
Corporal Nathan Cirillo , shot dead at #Ottawa War Memorial today , was 24 Reservist was member of Argyll and Sutherland Highlanders #cdnpoli	rumor
Thougts and prayers go out to everyone involved in the Paris terrorist situation Hope everyone comes out save ! 	non-rumor
#Ferguson PD releases robbery incident report smearing #MikeBrown but not shooting incident report Did they think we wouldn t notice \? 	rumor
Black bodies are no longer swinging from trees , they are laying on the streets #Ferguson #detriot #oakland #nyc #usa	non-rumor
Destruction of property and destruction of life are false equivalents #MikeBrown #Ferguson	non-rumor
Latest from printworks where #CharlieHebdo suspects had taken one hostage #ParisAttacks http t co 64ZQoajDw9 http t co LBwxBZMXmM	non-rumor
Sooooooo Chief of #Ferguson lied and said that an ambulance was on the scene \? #OpFerguson @OpFerguson @YourAnonNews http t co 1XX6A5Mt9x	rumor
142 passengers on board GermanWings plane which has crashed in French Alps , according to AFP	rumor
Police confirm 3rd shooting in area of Rideau Centre , mall in downtown #Ottawa east of Parliament Hill #cdnpoli	rumor
Ongoing hostage situation in Sydney caf #sydneysiege Major landmarks like the Sydney Opera House evacuated http t co fmvq54QmTO	rumor
10 people confirmed dead in Paris attack rocket launcher used in assault , according to reports http t co 7N7uvClhWY	rumor
BREAKING NEWS NAME OF OFFICER WHO SHOT #MIKEBROWN OFFICER DAREN WILSON #Ferguson	rumor
They wanted the people to crumble , instead they came together #JeSuisCharlie http t co UHOrggBdRp	non-rumor
#CharlieHebdo attacker We don t kill women but you have to convert to Islam , read the Qu ran and wear a veil http t co rpZHDQZddO	non-rumor
Sites evacuated now include State Library , Sydney Opera House , Channel 7 building in Martin Place http t co XrIutxD6Op #SydneySiege	rumor
On the darkest of days , like this , the French philosopher Voltaire perhaps say it best #CharlieHebdo http t co afM6QJUgrb	non-rumor
Today at 1030GMT #police officers and staff around the country will pause to remember those killed in yesterday 's #CharlieHebdo atrocity 	non-rumor
Video purportedly shows gunmen fleeing after opening fire at #CharlieHebdo offices in France http t co yNCZFyhV5a http t co 5M9IGKUGWR	non-rumor
Soldier shot at War Memorial in Ottawa has died Live coverage http t co pQpji0hgFI	rumor
BREAKING #Germanwings co pilot was recent Muslim convert http t co aqvtsI7OcV http t co BI5OLZJKJI	rumor
Your friendly local police department Protect and Serve #Ferguson http t co LIUfLlnXXK	non-rumor
#BREAKING Police storm hostage taker at Paris grocer http t co EoIuN5exh1 http t co uBrUorAGcA	non-rumor
Mumbai lawyer Vijay Gaekwad in jail for blaspheming the prophet No mention in msm as far as I'm aware #CharlieHebdo https t co 1O5qtJPEJJ	non-rumor
Do not share the video of masked gunmen at #CharlieHebdo offices executing a police officer It is barbaric amp his life should be respected 	non-rumor
Two women have emerged from the Lindt cafe in #Sydney Five hostages are now out #sydneysiege http t co 4MUc9ivwbK http t co oVrob5DLD3	rumor
Things are getting very tense in #Ferguson https t co 2pDUHAR2B7	non-rumor
AP took gt 4 photos of Charb with the famous cover UK papers are , AFAIK , only using bottom right one #CharlieHebdo http t co aKpB615dim	non-rumor
Question for #Ferguson police chief \? If OFFICER DARREN WILSON was in pursuit of a robbery suspect , why tell kids to get out of the road \? LIE	rumor
Video posted online appears to show gunmen fleeing after attack on #CharlieHebdo magazine office in Paris http t co bEri7HY51w	non-rumor
There 's a tank near the #Paris hostage scene http t co 7N7uvClhWY \( Pic Heathcliff O'Malley \) http t co EPXhd9k6GF	rumor
I do n't support the cartoons or language published by publishers BUT #CharlieHebdo attack is indeed sickening 11 dead in #terrorattack	non-rumor
Reminder that this is legal , but young unarmed black men are threatening and make us uncomfortable #Ferguson http t co VbRyW7J9nR	non-rumor
I wake up to #NAACPBombing and #CharlieHebdo massacre , the violence of both betraying the insecurity amp weakness of the assailants 	non-rumor
#NHL cancels tonight 's game between #Ottawa and #Toronto due to today 's shootings Senators were to host Maple Leafs 	rumor
Here 's the @NewYorker cartoonist 's response to the #CharlieHebdo attack https t co frxZ74TGOL	non-rumor
Remember this \? Those men died for our right to freedom of speech Do n't let that sacrifice be in vain #CharlieHebdo http t co vXzD9am4Zq	non-rumor
#BREAKING Hostage taken at kosher shop in #Paris by suspect in police officer shooting' https t co 4yt6nafpIg http t co f9N8Bjn68I	rumor
 @smokey You ca n't jump over a murder amp talk to me about some cigars @thereval @newsone #Ferguson #KeepingItRealRadio	rumor
Sydney Crisis Hostages share gunman 's demands in chilling phone calls http t co FBdZWWoNgg http t co EZEhfxRUMQ	rumor
The more you are motivated by Love , The more fearless amp free your action will be Dalai Lama #JeSuisCharlie @Asamsakti http t co s5Zlrb8IaX	non-rumor
A woman runs to police from cafe in Sydney during hostage crisis http t co xbLHYWGSdc	rumor
If rightwing radical Christians were killing people in U S amp Europe , would the hard left be bleating about Christianophobia \? #JeSuisCharlie	non-rumor
R I P Ahmed Merabet , a French Muslim cop , first victim of #CharlieHebdo #ParisShooting http t co CYQZhV8Sxc	rumor
This #Ferguson PD chief press conference is AMAZING he just ADMITTED Darren Wilson stopped him bc of the jaywalking 	rumor
#BREAKING Reports 2 dead in Paris kosher supermarket hostage situation http t co VsvZVWiQ19	rumor
DRAMATIC VIDEO #Sydneysiege hostages run from #Lindt Cafe , more remain trapped http t co AUy05vbZjh http t co n3a3mdMoYU	rumor
The moving tributes to the victims of the Charlie Hebdo shooting http t co pxRaFxCWMP http t co A8AisDaypj	non-rumor
Ca n't sleep tonight , thoughts with my French cartooning colleagues , their families and loved ones #CharlieHebdo http t co vJWi8AbE79	non-rumor
UPDATE Parts of #Sydney locked down amid cafe hostage crisis Sydney Opera House evacuated http t co UvMu4d0f9q http t co wmWyzhBHnw	rumor
GOD BLESS YOU #Ferguson RT @Daaance Ki Howard family pray for our own @SpookPacShakur http t co fW2CJgno6A	non-rumor
 After twenty years of writing about Muslim fundamentalist violence , I am running out of synonyms for atrocity http t co ngPatcYWYc	non-rumor
#CharlieHebdo tweeted this cartoon minutes before the attack http t co suTXnFLoPs http t co vOzw6ecOtO	non-rumor
NEW The #Salafi response to the #Terrorist #ParisShooting #France Were they forbidding an evil \? Please spread http t co g9QlYdXlUR	non-rumor
Strongly condemn the attack on #CharlieHebdo There is no justification for this brutal act My thoughts are with the families of victims 	non-rumor
#Ferguson cops beat innocent man , then charged him with bleeding on their uniforms http t co JUQ3pKvbCm http t co pByb9IUqew	rumor
#CharlieHebdo attack latest Footage shows Paris gunmen on rampage as policeman is shot http t co VkLHN9pxyf http t co LxHM3TuhQy	non-rumor
FT Charlie Hebdo was drunk and wearing a short skirt https t co FDSr82rCDv	non-rumor
BREAKING #CharlieHebdo Hebdo to be published next week in defiance of attack , with contributions from cartoonists from around the world 	non-rumor
The whistleblower said the #StLouis PD told the Black officers , Oh , not you you 're the good guys #Ferguson	non-rumor
You 're not Charlie Hebdo unless you are prepared to retweet its most offensive cartoons #iamcharlie http t co fbyn2UEcn0	non-rumor
How Arab world media responded to Charlie Hebdo attack http t co HF68AN5Oh0 http t co i8PVfgD3rq	non-rumor
BREAKING Gunmen in #CharlieHebdo massacre reportedly killed http t co pOJLo4rJps http t co XN0zMd5kaO	non-rumor
Soldier killed at war memorial identified as Nathan Cirillo #HamOnt #OttawaShooting #cndpoli http t co BjEM0my6iT http t co 7BFFBm2afL	rumor
Ottawa police confirm 3 separate shooting incidents today 1 on Parliament Hill , 1 at War Memorial and 1 near area mall @CP24 , @CBCNews	rumor
So lets recap No dashboard cam of the incident But definitely photos of Michael Brown in a store Funny how that happens #NMOS14 #Ferguson	rumor
Condolences to the family of the fallen officer in #Ottawa He was a hero who bravely stood in defence of our country and our freedoms	rumor
A picture of the gunman inside Lindt cafe at Martin Place Updates http t co mmOH7zakyB #SydneySiege http t co jqHrcjlseq	rumor
Someone please remind me what year it is again \? #ferguson http t co 33cebmojwV	non-rumor
Powerful video of protestors w hands up mocking #Ferguson police Video via @AntonioFrench #MikeBrown https t co PVXgMmgw20	non-rumor
Trayvon Martin Jordan Davis Renisha McBride Mike Brown Our streets are stained with the blood of unarmed , black teens #Ferguson	non-rumor
Make Fun of Hindu God 's #PK Creativity , Freedom of Expression Make Fun of A Prophet 12 killed #CharlieHebdo http t co 1qQGFtuhO2	non-rumor
Ahmed Merabet , a French #Muslim Cop , first victim of #CharlieHebdo attack , #JeSuisCharlie #IamCharlie #ParisShooting http t co G8D3mixbjX	rumor
Snipers , helicopters turn French town Dammartin en Goele into warzone Photo Dominique Faget #AFP http t co PnQiPlSWN0	non-rumor
Last words from #Germanwings A320 distress call were emergency , emergency , authorities say http t co FXVBrA7RPz http t co OxfPISsdvj	rumor
Independent cartoonist @DaveBrownToons on the story behind our #CharlieHebdo front page image http t co pmyzSyahAT http t co Lle6K8uPDg	non-rumor
The Ahmadiyya Muslim Community categorically condemns the attack at Charlie Hebdo Our thoughts are with the victims http t co kTsWb7SNaA	non-rumor
#Ferguson police say Michael Brown fit description of strong arm robbery suspect http t co bxXMNDzhe6	rumor
No matter what COLOR you are the murder by cop in #Ferguson is WRONG Let 's stand together , do NOT let them divide us 	non-rumor
I can only draw using my mouth , I did my best The pencil is stronger than the gun #JeSuisCharlie http t co AS6IGtJYum	non-rumor
Revenge attacks on Muslim spaces begin in France after #CharlieHebdo massacre http t co 50anhW9BEk http t co uKL5El7V2B	non-rumor
BREAKING Shots fired , hostages taken in manhunt for #CharlieHebdo attackers , police say http t co omBy6Wsgb7 http t co ZbszAHyIzJ	rumor
Ottawa police chief confirms that both gunman and soldier at war memorial are dead 	rumor
Sarkozy on #CharlieHebdo in 2011 prefer an excess of caricature to an excess of censorship http t co aQZBlwbwjJ http t co JDSRgnFoft	non-rumor
#Charlie Hebdo It was press day at the magazine so all important staff were there Now 10 assassinated along with 2 police officers 	rumor
87 y o French cartoonist Uderzo , creator of Asterix , comes out of retirement for #CharlieHebdo \( H T @WilliamsJon \) http t co 6uBOTl9pzO	non-rumor
#CharlieHebdo editor , murdered today , said in 2012 I prefer to die standing than to live on my knees #jesuischarly http t co OgnMfcIvE5	non-rumor
Cartoonists around the world respond to the #CharlieHebdo killings http t co JBX8K0Mzt6 http t co vxREqhUqw4	non-rumor
WOKE #Ferguson #mikebrown RT @ChamNature 10 mins RT @DragonflyJonez 6'4 290 In sandals RT @ TheSpeakEasy Hmm http t co urAzIWRNI6	rumor
France has ID cards and v extensive surveillance regime It did n't prevent #CharlieHebdo Do n't nod along with calls for more surveillance 	non-rumor
They broke out the terrorist response gear for citizens in #Ferguson protesting cold blooded police murder Are we still in America \? \? 	non-rumor
Operation underway in the Dammartin en Goele area , as police hunt Paris shooting suspects , French interior minister tells CNN affiliate 	rumor
I am devastated by what just happened in France #CharlieHebdo http t co IxEbScqYFh	non-rumor
So far today the UK media , while reporting on #CharlieHebdo , has pixelated images of a cartoon but happily posted a video of a brutal murder	non-rumor
Islam amp Muslims blamed even when neither have anything to do with mass killing #Germanwings #GermanWingsCrash http t co DKmNEqzPc7	rumor
For those who , like me , wish Christooher Hitchens were here to comment , do read this http t co rJKcBzGk0r \( via @elvis717 \) #JeSuisCharlie	non-rumor
We will not be intimidated by brutal , violent attacks on our freedom #JeSuisCharlie	non-rumor
Breaking Police confirm multiple suspects in Ottawa shooting http t co tYCeELTJqc	rumor
 @Maryam Rajavi message regarding the terrorist attacks in #Paris #Iran #IranTalks #CharlieHebdo #JeSuisCharlie http t co qzSu2oYs14	non-rumor
Editor Stephane Charbonnier , 4 cartoonists reported killed in #CharlieHebdo attack \( AP photo \) http t co qTB7uIurjN http t co GjglEVLmLF	non-rumor
What Charlie Hebdo does , and why terrorists use it as a pretext to justify their violence By @emserre , from 2012 http t co BIXn9x5GAp	non-rumor
BREAKING @SkyBusiness Sixth hostage escapes from #sydneysiege http t co oiEBHhAVeK \( @carsonscottLIVE \) 	rumor
